Datum;BundeslandID;Name;Testungen;TestungenPCR;TestungenAntigen
2021-03-01T09:30:00+01:00;1;Burgenland;638575;155435;483140
2021-03-01T09:30:00+01:00;2;Kärnten;675557;217933;457624
2021-03-01T09:30:00+01:00;3;Niederösterreich;3400756;1141984;2258772
2021-03-01T09:30:00+01:00;4;Oberösterreich;2162517;546777;1615740
2021-03-01T09:30:00+01:00;5;Salzburg;823353;274598;548755
2021-03-01T09:30:00+01:00;6;Steiermark;1758065;503274;1254791
2021-03-01T09:30:00+01:00;7;Tirol;1521757;579890;941867
2021-03-01T09:30:00+01:00;8;Vorarlberg;825612;298572;527040
2021-03-01T09:30:00+01:00;9;Wien;3197153;1677203;1519950
2021-03-01T09:30:00+01:00;10;Österreich;15003345;5395666;9607679
2021-03-02T09:30:00+01:00;1;Burgenland;645941;155933;490008
2021-03-02T09:30:00+01:00;2;Kärnten;704089;219190;484899
2021-03-02T09:30:00+01:00;3;Niederösterreich;3471229;1147138;2324091
2021-03-02T09:30:00+01:00;4;Oberösterreich;2241062;548394;1692668
2021-03-02T09:30:00+01:00;5;Salzburg;847370;275923;571447
2021-03-02T09:30:00+01:00;6;Steiermark;1801508;505525;1295983
2021-03-02T09:30:00+01:00;7;Tirol;1539898;583765;956133
2021-03-02T09:30:00+01:00;8;Vorarlberg;842170;299159;543011
2021-03-02T09:30:00+01:00;9;Wien;3264872;1721257;1543615
2021-03-02T09:30:00+01:00;10;Österreich;15358139;5456284;9901855
2021-03-03T09:30:00+01:00;1;Burgenland;656824;156596;500228
2021-03-03T09:30:00+01:00;2;Kärnten;708065;220503;487562
2021-03-03T09:30:00+01:00;3;Niederösterreich;3525810;1153997;2371813
2021-03-03T09:30:00+01:00;4;Oberösterreich;2276421;550375;1726046
2021-03-03T09:30:00+01:00;5;Salzburg;859248;277381;581867
2021-03-03T09:30:00+01:00;6;Steiermark;1852502;508297;1344205
2021-03-03T09:30:00+01:00;7;Tirol;1552380;588092;964288
2021-03-03T09:30:00+01:00;8;Vorarlberg;855489;300574;554915
2021-03-03T09:30:00+01:00;9;Wien;3316131;1751657;1564474
2021-03-03T09:30:00+01:00;10;Österreich;15602870;5507472;10095398
2021-03-04T09:30:00+01:00;1;Burgenland;665306;157400;507906
2021-03-04T09:30:00+01:00;2;Kärnten;709254;221614;487640
2021-03-04T09:30:00+01:00;3;Niederösterreich;3580743;1164883;2415860
2021-03-04T09:30:00+01:00;4;Oberösterreich;2332134;552588;1779546
2021-03-04T09:30:00+01:00;5;Salzburg;871522;278819;592703
2021-03-04T09:30:00+01:00;6;Steiermark;1899187;509514;1389673
2021-03-04T09:30:00+01:00;7;Tirol;1569811;591254;978557
2021-03-04T09:30:00+01:00;8;Vorarlberg;868793;301846;566947
2021-03-04T09:30:00+01:00;9;Wien;3367370;1779673;1587697
2021-03-04T09:30:00+01:00;10;Österreich;15864120;5557591;10306529
2021-03-05T09:30:00+01:00;1;Burgenland;677110;158537;518573
2021-03-05T09:30:00+01:00;2;Kärnten;710375;222676;487699
2021-03-05T09:30:00+01:00;3;Niederösterreich;3631722;1175337;2456385
2021-03-05T09:30:00+01:00;4;Oberösterreich;2368282;554878;1813404
2021-03-05T09:30:00+01:00;5;Salzburg;914767;280410;634357
2021-03-05T09:30:00+01:00;6;Steiermark;1929023;512435;1416588
2021-03-05T09:30:00+01:00;7;Tirol;1587729;594508;993221
2021-03-05T09:30:00+01:00;8;Vorarlberg;882629;302984;579645
2021-03-05T09:30:00+01:00;9;Wien;3421978;1808879;1613099
2021-03-05T09:30:00+01:00;10;Österreich;16123615;5610644;10512971
2021-03-06T09:30:00+01:00;1;Burgenland;692887;159511;533376
2021-03-06T09:30:00+01:00;2;Kärnten;711306;223558;487748
2021-03-06T09:30:00+01:00;3;Niederösterreich;3693241;1186373;2506868
2021-03-06T09:30:00+01:00;4;Oberösterreich;2407310;556843;1850467
2021-03-06T09:30:00+01:00;5;Salzburg;931315;281493;649822
2021-03-06T09:30:00+01:00;6;Steiermark;1966099;517914;1448185
2021-03-06T09:30:00+01:00;7;Tirol;1604167;597648;1006519
2021-03-06T09:30:00+01:00;8;Vorarlberg;896689;304480;592209
2021-03-06T09:30:00+01:00;9;Wien;3471274;1829876;1641398
2021-03-06T09:30:00+01:00;10;Österreich;16374288;5657696;10716592
2021-03-07T09:30:00+01:00;1;Burgenland;694733;160380;534353
2021-03-07T09:30:00+01:00;2;Kärnten;711909;224122;487787
2021-03-07T09:30:00+01:00;3;Niederösterreich;3738592;1195621;2542971
2021-03-07T09:30:00+01:00;4;Oberösterreich;2428659;558448;1870211
2021-03-07T09:30:00+01:00;5;Salzburg;939879;282427;657452
2021-03-07T09:30:00+01:00;6;Steiermark;1993544;520159;1473385
2021-03-07T09:30:00+01:00;7;Tirol;1619308;599943;1019365
2021-03-07T09:30:00+01:00;8;Vorarlberg;904537;305649;598888
2021-03-07T09:30:00+01:00;9;Wien;3501971;1836430;1665541
2021-03-07T09:30:00+01:00;10;Österreich;16533132;5683179;10849953
2021-03-08T09:30:00+01:00;1;Burgenland;705722;160835;544887
2021-03-08T09:30:00+01:00;2;Kärnten;713785;225967;487818
2021-03-08T09:30:00+01:00;3;Niederösterreich;3765805;1203769;2562036
2021-03-08T09:30:00+01:00;4;Oberösterreich;2452634;560051;1892583
2021-03-08T09:30:00+01:00;5;Salzburg;947009;283512;663497
2021-03-08T09:30:00+01:00;6;Steiermark;1996501;523116;1473385
2021-03-08T09:30:00+01:00;7;Tirol;1633325;602260;1031065
2021-03-08T09:30:00+01:00;8;Vorarlberg;911122;306153;604969
2021-03-08T09:30:00+01:00;9;Wien;3529309;1842699;1686610
2021-03-08T09:30:00+01:00;10;Österreich;16655212;5708362;10946850
2021-03-09T09:30:00+01:00;1;Burgenland;716398;161608;554790
2021-03-09T09:30:00+01:00;2;Kärnten;763750;227722;536028
2021-03-09T09:30:00+01:00;3;Niederösterreich;3824765;1209202;2615563
2021-03-09T09:30:00+01:00;4;Oberösterreich;2517626;562396;1955230
2021-03-09T09:30:00+01:00;5;Salzburg;982741;284782;697959
2021-03-09T09:30:00+01:00;6;Steiermark;2066437;526879;1539558
2021-03-09T09:30:00+01:00;7;Tirol;1645194;605377;1039817
2021-03-09T09:30:00+01:00;8;Vorarlberg;926254;306739;619515
2021-03-09T09:30:00+01:00;9;Wien;3607954;1893903;1714051
2021-03-09T09:30:00+01:00;10;Österreich;17051119;5778608;11272511
2021-03-10T09:30:00+01:00;1;Burgenland;725692;162864;562828
2021-03-10T09:30:00+01:00;2;Kärnten;780153;228854;551299
2021-03-10T09:30:00+01:00;3;Niederösterreich;3885068;1214172;2670896
2021-03-10T09:30:00+01:00;4;Oberösterreich;2560979;564876;1996103
2021-03-10T09:30:00+01:00;5;Salzburg;1001876;286638;715238
2021-03-10T09:30:00+01:00;6;Steiermark;2117895;529564;1588331
2021-03-10T09:30:00+01:00;7;Tirol;1656543;608527;1048016
2021-03-10T09:30:00+01:00;8;Vorarlberg;940650;308199;632451
2021-03-10T09:30:00+01:00;9;Wien;3660447;1924329;1736118
2021-03-10T09:30:00+01:00;10;Österreich;17329303;5828023;11501280
2021-03-11T09:30:00+01:00;1;Burgenland;735955;163979;571976
2021-03-11T09:30:00+01:00;2;Kärnten;780828;229447;551381
2021-03-11T09:30:00+01:00;3;Niederösterreich;3930268;1226953;2703315
2021-03-11T09:30:00+01:00;4;Oberösterreich;2617695;567105;2050590
2021-03-11T09:30:00+01:00;5;Salzburg;1023271;288373;734898
2021-03-11T09:30:00+01:00;6;Steiermark;2145853;532499;1613354
2021-03-11T09:30:00+01:00;7;Tirol;1669705;612427;1057278
2021-03-11T09:30:00+01:00;8;Vorarlberg;953849;309421;644428
2021-03-11T09:30:00+01:00;9;Wien;3691533;1948622;1742911
2021-03-11T09:30:00+01:00;10;Österreich;17548957;5878826;11670131
2021-03-12T09:30:00+01:00;1;Burgenland;745729;164996;580733
2021-03-12T09:30:00+01:00;2;Kärnten;782016;230545;551471
2021-03-12T09:30:00+01:00;3;Niederösterreich;4004202;1237497;2766705
2021-03-12T09:30:00+01:00;4;Oberösterreich;2658827;569777;2089050
2021-03-12T09:30:00+01:00;5;Salzburg;1042456;289875;752581
2021-03-12T09:30:00+01:00;6;Steiermark;2174570;533535;1641035
2021-03-12T09:30:00+01:00;7;Tirol;1762040;616766;1145274
2021-03-12T09:30:00+01:00;8;Vorarlberg;968333;310843;657490
2021-03-12T09:30:00+01:00;9;Wien;3768674;1982707;1785967
2021-03-12T09:30:00+01:00;10;Österreich;17906847;5936541;11970306
2021-03-13T09:30:00+01:00;1;Burgenland;765111;165863;599248
2021-03-13T09:30:00+01:00;2;Kärnten;783011;231450;551561
2021-03-13T09:30:00+01:00;3;Niederösterreich;4079284;1250051;2829233
2021-03-13T09:30:00+01:00;4;Oberösterreich;2699892;572111;2127781
2021-03-13T09:30:00+01:00;5;Salzburg;1065238;291240;773998
2021-03-13T09:30:00+01:00;6;Steiermark;2215308;539493;1675815
2021-03-13T09:30:00+01:00;7;Tirol;1780612;620933;1159679
2021-03-13T09:30:00+01:00;8;Vorarlberg;982335;312309;670026
2021-03-13T09:30:00+01:00;9;Wien;3807817;1994653;1813164
2021-03-13T09:30:00+01:00;10;Österreich;18178608;5978103;12200505
2021-03-14T09:30:00+01:00;1;Burgenland;772126;166899;605227
2021-03-14T09:30:00+01:00;2;Kärnten;783426;231848;551578
2021-03-14T09:30:00+01:00;3;Niederösterreich;4130698;1259580;2871118
2021-03-14T09:30:00+01:00;4;Oberösterreich;2722516;574282;2148234
2021-03-14T09:30:00+01:00;5;Salzburg;1075448;292294;783154
2021-03-14T09:30:00+01:00;6;Steiermark;2243171;541719;1701452
2021-03-14T09:30:00+01:00;7;Tirol;1794959;624658;1170301
2021-03-14T09:30:00+01:00;8;Vorarlberg;990424;313553;676871
2021-03-14T09:30:00+01:00;9;Wien;3833275;1999834;1833441
2021-03-14T09:30:00+01:00;10;Österreich;18346043;6004667;12341376
2021-03-15T09:30:00+01:00;1;Burgenland;778154;167469;610685
2021-03-15T09:30:00+01:00;2;Kärnten;785396;233795;551601
2021-03-15T09:30:00+01:00;3;Niederösterreich;4167187;1267556;2899631
2021-03-15T09:30:00+01:00;4;Oberösterreich;2749652;576547;2173105
2021-03-15T09:30:00+01:00;5;Salzburg;1077012;293760;783252
2021-03-15T09:30:00+01:00;6;Steiermark;2247450;545998;1701452
2021-03-15T09:30:00+01:00;7;Tirol;1811508;629138;1182370
2021-03-15T09:30:00+01:00;8;Vorarlberg;998950;314260;684690
2021-03-15T09:30:00+01:00;9;Wien;3869837;2005304;1864533
2021-03-15T09:30:00+01:00;10;Österreich;18485146;6033827;12451319
2021-03-16T09:30:00+01:00;1;Burgenland;790271;168495;621776
2021-03-16T09:30:00+01:00;2;Kärnten;786786;235099;551687
2021-03-16T09:30:00+01:00;3;Niederösterreich;4239419;1273437;2965982
2021-03-16T09:30:00+01:00;4;Oberösterreich;2819376;578865;2240511
2021-03-16T09:30:00+01:00;5;Salzburg;1102571;295314;807257
2021-03-16T09:30:00+01:00;6;Steiermark;2345419;549514;1795905
2021-03-16T09:30:00+01:00;7;Tirol;1826809;634117;1192692
2021-03-16T09:30:00+01:00;8;Vorarlberg;1015789;314912;700877
2021-03-16T09:30:00+01:00;9;Wien;3914427;2023848;1890579
2021-03-16T09:30:00+01:00;10;Österreich;18840867;6073601;12767266
2021-03-17T09:30:00+01:00;1;Burgenland;799358;169159;630199
2021-03-17T09:30:00+01:00;2;Kärnten;870998;236238;634760
2021-03-17T09:30:00+01:00;3;Niederösterreich;4307909;1280082;3027827
2021-03-17T09:30:00+01:00;4;Oberösterreich;2851427;580588;2270839
2021-03-17T09:30:00+01:00;5;Salzburg;1122193;297447;824746
2021-03-17T09:30:00+01:00;6;Steiermark;2396525;551159;1845366
2021-03-17T09:30:00+01:00;7;Tirol;1937323;640101;1297222
2021-03-17T09:30:00+01:00;8;Vorarlberg;1033799;316342;717457
2021-03-17T09:30:00+01:00;9;Wien;3957995;2045013;1912982
2021-03-17T09:30:00+01:00;10;Österreich;19277527;6116129;13161398
2021-03-18T09:30:00+01:00;1;Burgenland;809593;170019;639574
2021-03-18T09:30:00+01:00;2;Kärnten;871799;237039;634760
2021-03-18T09:30:00+01:00;3;Niederösterreich;4377441;1289028;3088413
2021-03-18T09:30:00+01:00;4;Oberösterreich;2927953;583231;2344722
2021-03-18T09:30:00+01:00;5;Salzburg;1142497;299314;843183
2021-03-18T09:30:00+01:00;6;Steiermark;2426106;553683;1872423
2021-03-18T09:30:00+01:00;7;Tirol;1953024;644858;1308166
2021-03-18T09:30:00+01:00;8;Vorarlberg;1064740;331334;733406
2021-03-18T09:30:00+01:00;9;Wien;4002957;2064415;1938542
2021-03-18T09:30:00+01:00;10;Österreich;19576110;6172921;13403189
2021-03-19T09:30:00+01:00;1;Burgenland;823041;170684;652357
2021-03-19T09:30:00+01:00;2;Kärnten;872716;237799;634917
2021-03-19T09:30:00+01:00;3;Niederösterreich;4452446;1303447;3148999
2021-03-19T09:30:00+01:00;4;Oberösterreich;2958465;586089;2372376
2021-03-19T09:30:00+01:00;5;Salzburg;1161332;300917;860415
2021-03-19T09:30:00+01:00;6;Steiermark;2459841;558554;1901287
2021-03-19T09:30:00+01:00;7;Tirol;1969077;649901;1319176
2021-03-19T09:30:00+01:00;8;Vorarlberg;1098690;346817;751873
2021-03-19T09:30:00+01:00;9;Wien;4049950;2084547;1965403
2021-03-19T09:30:00+01:00;10;Österreich;19845558;6238755;13606803
2021-03-20T09:30:00+01:00;1;Burgenland;835606;171866;663740
2021-03-20T09:30:00+01:00;2;Kärnten;873766;238734;635032
2021-03-20T09:30:00+01:00;3;Niederösterreich;4526483;1314724;3211759
2021-03-20T09:30:00+01:00;4;Oberösterreich;2991505;588202;2403303
2021-03-20T09:30:00+01:00;5;Salzburg;1184231;302701;881530
2021-03-20T09:30:00+01:00;6;Steiermark;2493346;560759;1932587
2021-03-20T09:30:00+01:00;7;Tirol;1986242;654513;1331729
2021-03-20T09:30:00+01:00;8;Vorarlberg;1141970;363835;778135
2021-03-20T09:30:00+01:00;9;Wien;4090443;2094724;1995719
2021-03-20T09:30:00+01:00;10;Österreich;20123592;6290058;13833534
2021-03-21T09:30:00+01:00;1;Burgenland;842503;173335;669168
2021-03-21T09:30:00+01:00;2;Kärnten;874442;239351;635091
2021-03-21T09:30:00+01:00;3;Niederösterreich;4579366;1326016;3253350
2021-03-21T09:30:00+01:00;4;Oberösterreich;3014683;590380;2424303
2021-03-21T09:30:00+01:00;5;Salzburg;1194163;303841;890322
2021-03-21T09:30:00+01:00;6;Steiermark;2519857;562317;1957540
2021-03-21T09:30:00+01:00;7;Tirol;1990374;658645;1331729
2021-03-21T09:30:00+01:00;8;Vorarlberg;1182027;388614;793413
2021-03-21T09:30:00+01:00;9;Wien;4119141;2099208;2019933
2021-03-21T09:30:00+01:00;10;Österreich;20316556;6341707;13974849
2021-03-22T09:30:00+01:00;1;Burgenland;849033;173957;675076
2021-03-22T09:30:00+01:00;2;Kärnten;876391;241262;635129
2021-03-22T09:30:00+01:00;3;Niederösterreich;4617906;1334355;3283551
2021-03-22T09:30:00+01:00;4;Oberösterreich;3040358;591821;2448537
2021-03-22T09:30:00+01:00;5;Salzburg;1195805;305136;890669
2021-03-22T09:30:00+01:00;6;Steiermark;2521739;564199;1957540
2021-03-22T09:30:00+01:00;7;Tirol;2019901;664006;1355895
2021-03-22T09:30:00+01:00;8;Vorarlberg;1205686;404002;801684
2021-03-22T09:30:00+01:00;9;Wien;4149666;2103661;2046005
2021-03-22T09:30:00+01:00;10;Österreich;20476485;6382399;14094086
2021-03-23T09:30:00+01:00;1;Burgenland;861558;174679;686879
2021-03-23T09:30:00+01:00;2;Kärnten;929695;242218;687477
2021-03-23T09:30:00+01:00;3;Niederösterreich;4694800;1339132;3355668
2021-03-23T09:30:00+01:00;4;Oberösterreich;3088116;594780;2493336
2021-03-23T09:30:00+01:00;5;Salzburg;1232030;306604;925426
2021-03-23T09:30:00+01:00;6;Steiermark;2572266;568895;2003371
2021-03-23T09:30:00+01:00;7;Tirol;2036946;670212;1366734
2021-03-23T09:30:00+01:00;8;Vorarlberg;1234614;412368;822246
2021-03-23T09:30:00+01:00;9;Wien;4196267;2122678;2073589
2021-03-23T09:30:00+01:00;10;Österreich;20846292;6431566;14414726
2021-03-24T09:30:00+01:00;1;Burgenland;872896;176121;696775
2021-03-24T09:30:00+01:00;2;Kärnten;931134;243164;687970
2021-03-24T09:30:00+01:00;3;Niederösterreich;4767494;1345120;3422374
2021-03-24T09:30:00+01:00;4;Oberösterreich;3129752;598002;2531750
2021-03-24T09:30:00+01:00;5;Salzburg;1252911;308780;944131
2021-03-24T09:30:00+01:00;6;Steiermark;2625970;571728;2054242
2021-03-24T09:30:00+01:00;7;Tirol;2053643;676228;1377415
2021-03-24T09:30:00+01:00;8;Vorarlberg;1273158;431299;841859
2021-03-24T09:30:00+01:00;9;Wien;4240176;2142874;2097302
2021-03-24T09:30:00+01:00;10;Österreich;21147134;6493316;14653818
2021-03-25T09:30:00+01:00;1;Burgenland;884164;177254;706910
2021-03-25T09:30:00+01:00;2;Kärnten;932192;244147;688045
2021-03-25T09:30:00+01:00;3;Niederösterreich;4855242;1358212;3497030
2021-03-25T09:30:00+01:00;4;Oberösterreich;3184428;600979;2583449
2021-03-25T09:30:00+01:00;5;Salzburg;1274885;311110;963775
2021-03-25T09:30:00+01:00;6;Steiermark;2657562;575061;2082501
2021-03-25T09:30:00+01:00;7;Tirol;2178261;681990;1496271
2021-03-25T09:30:00+01:00;8;Vorarlberg;1313899;448492;865407
2021-03-25T09:30:00+01:00;9;Wien;4284829;2171309;2113520
2021-03-25T09:30:00+01:00;10;Österreich;21565462;6568554;14996908
2021-03-26T09:30:00+01:00;1;Burgenland;899869;178434;721435
2021-03-26T09:30:00+01:00;2;Kärnten;933153;245108;688045
2021-03-26T09:30:00+01:00;3;Niederösterreich;4935497;1369259;3566238
2021-03-26T09:30:00+01:00;4;Oberösterreich;3218056;604271;2613785
2021-03-26T09:30:00+01:00;5;Salzburg;1295737;312885;982852
2021-03-26T09:30:00+01:00;6;Steiermark;2663502;578496;2085006
2021-03-26T09:30:00+01:00;7;Tirol;2194887;687087;1507800
2021-03-26T09:30:00+01:00;8;Vorarlberg;1337430;472023;865407
2021-03-26T09:30:00+01:00;9;Wien;4572963;2109209;2463754
2021-03-26T09:30:00+01:00;10;Österreich;22051094;6556772;15494322
2021-03-27T09:30:00+01:00;1;Burgenland;917549;179517;738032
2021-03-27T09:30:00+01:00;2;Kärnten;934164;246030;688134
2021-03-27T09:30:00+01:00;3;Niederösterreich;5025191;1381885;3643306
2021-03-27T09:30:00+01:00;4;Oberösterreich;3252545;606881;2645664
2021-03-27T09:30:00+01:00;5;Salzburg;1320211;314792;1005419
2021-03-27T09:30:00+01:00;6;Steiermark;2698663;580529;2118134
2021-03-27T09:30:00+01:00;7;Tirol;2211937;691486;1520451
2021-03-27T09:30:00+01:00;8;Vorarlberg;1196919;195074;1001845
2021-03-27T09:30:00+01:00;9;Wien;4637257;2137532;2499725
2021-03-27T09:30:00+01:00;10;Österreich;22194436;6333726;15860710
2021-03-28T09:30:00+02:00;1;Burgenland;927611;180786;746825
2021-03-28T09:30:00+02:00;2;Kärnten;934873;246684;688189
2021-03-28T09:30:00+02:00;3;Niederösterreich;5086477;1388767;3697710
2021-03-28T09:30:00+02:00;4;Oberösterreich;3276807;609524;2667283
2021-03-28T09:30:00+02:00;5;Salzburg;1331590;315978;1015612
2021-03-28T09:30:00+02:00;6;Steiermark;2755439;582924;2172515
2021-03-28T09:30:00+02:00;7;Tirol;2229212;696416;1532796
2021-03-28T09:30:00+02:00;8;Vorarlberg;1218096;195695;1022401
2021-03-28T09:30:00+02:00;9;Wien;4695367;2166958;2528409
2021-03-28T09:30:00+02:00;10;Österreich;22455472;6383732;16071740
2021-03-29T09:30:00+02:00;1;Burgenland;934721;181467;753254
2021-03-29T09:30:00+02:00;2;Kärnten;936879;248648;688231
2021-03-29T09:30:00+02:00;3;Niederösterreich;5124040;1396330;3727710
2021-03-29T09:30:00+02:00;4;Oberösterreich;3301345;611519;2689826
2021-03-29T09:30:00+02:00;5;Salzburg;1333746;317540;1016206
2021-03-29T09:30:00+02:00;6;Steiermark;2758920;586405;2172515
2021-03-29T09:30:00+02:00;7;Tirol;2247085;700979;1546106
2021-03-29T09:30:00+02:00;8;Vorarlberg;1231825;196321;1035504
2021-03-29T09:30:00+02:00;9;Wien;4741699;2182556;2559143
2021-03-29T09:30:00+02:00;10;Österreich;22610260;6421765;16188495
2021-03-30T09:30:00+02:00;1;Burgenland;949104;182242;766862
2021-03-30T09:30:00+02:00;2;Kärnten;972454;249536;722918
2021-03-30T09:30:00+02:00;3;Niederösterreich;5245241;1406001;3839240
2021-03-30T09:30:00+02:00;4;Oberösterreich;3330249;614299;2715950
2021-03-30T09:30:00+02:00;5;Salzburg;1368198;318944;1049254
2021-03-30T09:30:00+02:00;6;Steiermark;2805617;589669;2215948
2021-03-30T09:30:00+02:00;7;Tirol;2357712;706629;1651083
2021-03-30T09:30:00+02:00;8;Vorarlberg;1260864;196870;1063994
2021-03-30T09:30:00+02:00;9;Wien;4803867;2210079;2593788
2021-03-30T09:30:00+02:00;10;Österreich;23093306;6474269;16619037
2021-03-31T09:30:00+02:00;1;Burgenland;961060;183395;777665
2021-03-31T09:30:00+02:00;2;Kärnten;990186;250521;739665
2021-03-31T09:30:00+02:00;3;Niederösterreich;5335669;1414134;3921535
2021-03-31T09:30:00+02:00;4;Oberösterreich;3367362;616943;2750419
2021-03-31T09:30:00+02:00;5;Salzburg;1388828;320800;1068028
2021-03-31T09:30:00+02:00;6;Steiermark;2862543;591326;2271217
2021-03-31T09:30:00+02:00;7;Tirol;2376380;712407;1663973
2021-03-31T09:30:00+02:00;8;Vorarlberg;1287471;197522;1089949
2021-03-31T09:30:00+02:00;9;Wien;4882022;2256011;2626011
2021-03-31T09:30:00+02:00;10;Österreich;23451521;6543059;16908462
2021-04-01T09:30:00+02:00;1;Burgenland;974111;184672;789439
2021-04-01T09:30:00+02:00;2;Kärnten;1020563;251514;769049
2021-04-01T09:30:00+02:00;3;Niederösterreich;5413536;1424498;3989038
2021-04-01T09:30:00+02:00;4;Oberösterreich;3419985;619390;2800595
2021-04-01T09:30:00+02:00;5;Salzburg;1410452;322479;1087973
2021-04-01T09:30:00+02:00;6;Steiermark;2894660;593978;2300682
2021-04-01T09:30:00+02:00;7;Tirol;2395114;718645;1676469
2021-04-01T09:30:00+02:00;8;Vorarlberg;1316236;198330;1117906
2021-04-01T09:30:00+02:00;9;Wien;4960583;2302634;2657949
2021-04-01T09:30:00+02:00;10;Österreich;23805240;6616140;17189100
2021-04-02T09:30:00+02:00;1;Burgenland;982101;185541;796560
2021-04-02T09:30:00+02:00;2;Kärnten;1021313;252215;769098
2021-04-02T09:30:00+02:00;3;Niederösterreich;5481795;1436676;4045119
2021-04-02T09:30:00+02:00;4;Oberösterreich;3453475;621864;2831611
2021-04-02T09:30:00+02:00;5;Salzburg;1432749;324151;1108598
2021-04-02T09:30:00+02:00;6;Steiermark;2934598;598097;2336501
2021-04-02T09:30:00+02:00;7;Tirol;2413237;724157;1689080
2021-04-02T09:30:00+02:00;8;Vorarlberg;1341643;199063;1142580
2021-04-02T09:30:00+02:00;9;Wien;5025512;2344036;2681476
2021-04-02T09:30:00+02:00;10;Österreich;24086423;6685800;17400623
2021-04-03T09:30:00+02:00;1;Burgenland;1002217;186445;815772
2021-04-03T09:30:00+02:00;2;Kärnten;1022572;253451;769121
2021-04-03T09:30:00+02:00;3;Niederösterreich;5559735;1448714;4111021
2021-04-03T09:30:00+02:00;4;Oberösterreich;3492403;624352;2868051
2021-04-03T09:30:00+02:00;5;Salzburg;1461084;325658;1135426
2021-04-03T09:30:00+02:00;6;Steiermark;2974104;599886;2374218
2021-04-03T09:30:00+02:00;7;Tirol;2432393;729771;1702622
2021-04-03T09:30:00+02:00;8;Vorarlberg;1377060;199918;1177142
2021-04-03T09:30:00+02:00;9;Wien;5081347;2377323;2704024
2021-04-03T09:30:00+02:00;10;Österreich;24402915;6745518;17657397
2021-04-04T09:30:00+02:00;1;Burgenland;1008849;187349;821500
2021-04-04T09:30:00+02:00;2;Kärnten;1023272;254140;769132
2021-04-04T09:30:00+02:00;3;Niederösterreich;5627205;1459284;4167921
2021-04-04T09:30:00+02:00;4;Oberösterreich;3528840;626331;2902509
2021-04-04T09:30:00+02:00;5;Salzburg;1475805;326547;1149258
2021-04-04T09:30:00+02:00;6;Steiermark;2994313;602646;2391667
2021-04-04T09:30:00+02:00;7;Tirol;2452467;736297;1716170
2021-04-04T09:30:00+02:00;8;Vorarlberg;1404146;200514;1203632
2021-04-04T09:30:00+02:00;9;Wien;5132574;2407832;2724742
2021-04-04T09:30:00+02:00;10;Österreich;24647471;6800940;17846531
2021-04-05T09:30:00+02:00;1;Burgenland;1013451;188113;825338
2021-04-05T09:30:00+02:00;2;Kärnten;1023928;254782;769146
2021-04-05T09:30:00+02:00;3;Niederösterreich;5667003;1468744;4198259
2021-04-05T09:30:00+02:00;4;Oberösterreich;3554759;628066;2926693
2021-04-05T09:30:00+02:00;5;Salzburg;1477274;327327;1149947
2021-04-05T09:30:00+02:00;6;Steiermark;2995783;604116;2391667
2021-04-05T09:30:00+02:00;7;Tirol;2470439;740979;1729460
2021-04-05T09:30:00+02:00;8;Vorarlberg;1407607;200919;1206688
2021-04-05T09:30:00+02:00;9;Wien;5169561;2427382;2742179
2021-04-05T09:30:00+02:00;10;Österreich;24779805;6840428;17939377
2021-04-06T09:30:00+02:00;1;Burgenland;1022796;188567;834229
2021-04-06T09:30:00+02:00;2;Kärnten;1024436;255285;769151
2021-04-06T09:30:00+02:00;3;Niederösterreich;5724746;1475199;4249547
2021-04-06T09:30:00+02:00;4;Oberösterreich;3596428;629818;2966610
2021-04-06T09:30:00+02:00;5;Salzburg;1488972;328297;1160675
2021-04-06T09:30:00+02:00;6;Steiermark;3020536;605935;2414601
2021-04-06T09:30:00+02:00;7;Tirol;2491656;747621;1744035
2021-04-06T09:30:00+02:00;8;Vorarlberg;1426164;201209;1224955
2021-04-06T09:30:00+02:00;9;Wien;5203615;2435707;2767908
2021-04-06T09:30:00+02:00;10;Österreich;24999349;6867638;18131711
2021-04-07T09:30:00+02:00;1;Burgenland;1033403;189366;844037
2021-04-07T09:30:00+02:00;2;Kärnten;1038815;256459;782356
2021-04-07T09:30:00+02:00;3;Niederösterreich;5801219;1481130;4320089
2021-04-07T09:30:00+02:00;4;Oberösterreich;3656302;631815;3024487
2021-04-07T09:30:00+02:00;5;Salzburg;1530422;329902;1200520
2021-04-07T09:30:00+02:00;6;Steiermark;3091240;609540;2481700
2021-04-07T09:30:00+02:00;7;Tirol;2650259;753905;1896354
2021-04-07T09:30:00+02:00;8;Vorarlberg;1458976;210354;1248622
2021-04-07T09:30:00+02:00;9;Wien;5255361;2473660;2781701
2021-04-07T09:30:00+02:00;10;Österreich;25515997;6936131;18579866
2021-04-08T09:30:00+02:00;1;Burgenland;1047236;190519;856717
2021-04-08T09:30:00+02:00;2;Kärnten;1072569;257448;815121
2021-04-08T09:30:00+02:00;3;Niederösterreich;5879319;1487543;4391776
2021-04-08T09:30:00+02:00;4;Oberösterreich;3723290;634877;3088413
2021-04-08T09:30:00+02:00;5;Salzburg;1552358;331327;1221031
2021-04-08T09:30:00+02:00;6;Steiermark;3125254;612388;2512866
2021-04-08T09:30:00+02:00;7;Tirol;2665899;759518;1906381
2021-04-08T09:30:00+02:00;8;Vorarlberg;1482416;211060;1271356
2021-04-08T09:30:00+02:00;9;Wien;5320157;2518947;2801210
2021-04-08T09:30:00+02:00;10;Österreich;25868498;7003627;18864871
2021-04-09T09:30:00+02:00;1;Burgenland;1056992;190718;866274
2021-04-09T09:30:00+02:00;2;Kärnten;1073542;258421;815121
2021-04-09T09:30:00+02:00;3;Niederösterreich;5950688;1500073;4450615
2021-04-09T09:30:00+02:00;4;Oberösterreich;3777942;636911;3141031
2021-04-09T09:30:00+02:00;5;Salzburg;1574675;333300;1241375
2021-04-09T09:30:00+02:00;6;Steiermark;3155878;615068;2540810
2021-04-09T09:30:00+02:00;7;Tirol;2680352;764801;1915551
2021-04-09T09:30:00+02:00;8;Vorarlberg;1506813;211873;1294940
2021-04-09T09:30:00+02:00;9;Wien;5384956;2568944;2816012
2021-04-09T09:30:00+02:00;10;Österreich;26161838;7080109;19081729
2021-04-10T09:30:00+02:00;1;Burgenland;1074010;192082;881928
2021-04-10T09:30:00+02:00;2;Kärnten;1074447;259287;815160
2021-04-10T09:30:00+02:00;3;Niederösterreich;6031253;1512942;4518311
2021-04-10T09:30:00+02:00;4;Oberösterreich;3815087;639278;3175809
2021-04-10T09:30:00+02:00;5;Salzburg;1599158;334662;1264496
2021-04-10T09:30:00+02:00;6;Steiermark;3192321;617164;2575157
2021-04-10T09:30:00+02:00;7;Tirol;2696118;769685;1926433
2021-04-10T09:30:00+02:00;8;Vorarlberg;1541976;212752;1329224
2021-04-10T09:30:00+02:00;9;Wien;5453864;2613347;2840517
2021-04-10T09:30:00+02:00;10;Österreich;26478234;7151199;19327035
2021-04-11T09:30:00+02:00;1;Burgenland;1080084;192865;887219
2021-04-11T09:30:00+02:00;2;Kärnten;1075064;259873;815191
2021-04-11T09:30:00+02:00;3;Niederösterreich;6091597;1522522;4569075
2021-04-11T09:30:00+02:00;4;Oberösterreich;3838614;641239;3197375
2021-04-11T09:30:00+02:00;5;Salzburg;1609352;335478;1273874
2021-04-11T09:30:00+02:00;6;Steiermark;3218761;619362;2599399
2021-04-11T09:30:00+02:00;7;Tirol;2710948;772907;1938041
2021-04-11T09:30:00+02:00;8;Vorarlberg;1561244;213437;1347807
2021-04-11T09:30:00+02:00;9;Wien;5493411;2636299;2857112
2021-04-11T09:30:00+02:00;10;Österreich;26679075;7193982;19485093
2021-04-12T09:30:00+02:00;1;Burgenland;1088980;193387;895593
2021-04-12T09:30:00+02:00;2;Kärnten;1075839;260607;815232
2021-04-12T09:30:00+02:00;3;Niederösterreich;6150105;1532200;4617905
2021-04-12T09:30:00+02:00;4;Oberösterreich;3867780;642839;3224941
2021-04-12T09:30:00+02:00;5;Salzburg;1610352;336166;1274186
2021-04-12T09:30:00+02:00;6;Steiermark;3219891;620492;2599399
2021-04-12T09:30:00+02:00;7;Tirol;2730185;777665;1952520
2021-04-12T09:30:00+02:00;8;Vorarlberg;1570346;214084;1356262
2021-04-12T09:30:00+02:00;9;Wien;5535105;2654569;2880536
2021-04-12T09:30:00+02:00;10;Österreich;26848583;7232009;19616574
2021-04-13T09:30:00+02:00;1;Burgenland;1103951;194033;909918
2021-04-13T09:30:00+02:00;2;Kärnten;1078270;262976;815294
2021-04-13T09:30:00+02:00;3;Niederösterreich;6231831;1540451;4691380
2021-04-13T09:30:00+02:00;4;Oberösterreich;3919154;645042;3274112
2021-04-13T09:30:00+02:00;5;Salzburg;1643547;337913;1305634
2021-04-13T09:30:00+02:00;6;Steiermark;3268387;622791;2645596
2021-04-13T09:30:00+02:00;7;Tirol;2745213;782826;1962387
2021-04-13T09:30:00+02:00;8;Vorarlberg;1595090;214938;1380152
2021-04-13T09:30:00+02:00;9;Wien;5612418;2699569;2912849
2021-04-13T09:30:00+02:00;10;Österreich;27197861;7300539;19897322
2021-04-14T09:30:00+02:00;1;Burgenland;1114375;195012;919363
2021-04-14T09:30:00+02:00;2;Kärnten;1133191;264027;869164
2021-04-14T09:30:00+02:00;3;Niederösterreich;6293966;1547429;4746537
2021-04-14T09:30:00+02:00;4;Oberösterreich;3956051;647628;3308423
2021-04-14T09:30:00+02:00;5;Salzburg;1661810;339601;1322209
2021-04-14T09:30:00+02:00;6;Steiermark;3323246;628255;2694991
2021-04-14T09:30:00+02:00;7;Tirol;2915780;788036;2127744
2021-04-14T09:30:00+02:00;8;Vorarlberg;1615633;215594;1400039
2021-04-14T09:30:00+02:00;9;Wien;5689086;2749355;2939731
2021-04-14T09:30:00+02:00;10;Österreich;27703138;7374937;20328201
2021-04-15T09:30:00+02:00;1;Burgenland;1124722;195989;928733
2021-04-15T09:30:00+02:00;2;Kärnten;1134988;265061;869927
2021-04-15T09:30:00+02:00;3;Niederösterreich;6372472;1559584;4812888
2021-04-15T09:30:00+02:00;4;Oberösterreich;4017569;650147;3367422
2021-04-15T09:30:00+02:00;5;Salzburg;1680364;341302;1339062
2021-04-15T09:30:00+02:00;6;Steiermark;3350944;630804;2720140
2021-04-15T09:30:00+02:00;7;Tirol;2930215;792534;2137681
2021-04-15T09:30:00+02:00;8;Vorarlberg;1638246;216525;1421721
2021-04-15T09:30:00+02:00;9;Wien;5762561;2794278;2968283
2021-04-15T09:30:00+02:00;10;Österreich;28012081;7446224;20565857
2021-04-16T09:30:00+02:00;1;Burgenland;1137008;197129;939879
2021-04-16T09:30:00+02:00;2;Kärnten;1136054;266127;869927
2021-04-16T09:30:00+02:00;3;Niederösterreich;6442862;1570743;4872119
2021-04-16T09:30:00+02:00;4;Oberösterreich;4048640;652499;3396141
2021-04-16T09:30:00+02:00;5;Salzburg;1698584;342628;1355956
2021-04-16T09:30:00+02:00;6;Steiermark;3378556;632973;2745583
2021-04-16T09:30:00+02:00;7;Tirol;2944140;796670;2147470
2021-04-16T09:30:00+02:00;8;Vorarlberg;1661149;217215;1443934
2021-04-16T09:30:00+02:00;9;Wien;5851627;2854118;2997509
2021-04-16T09:30:00+02:00;10;Österreich;28298620;7530102;20768518
2021-04-17T09:30:00+02:00;1;Burgenland;1154895;197915;956980
2021-04-17T09:30:00+02:00;2;Kärnten;1137011;267048;869963
2021-04-17T09:30:00+02:00;3;Niederösterreich;6520787;1582013;4938774
2021-04-17T09:30:00+02:00;4;Oberösterreich;4084120;655064;3429056
2021-04-17T09:30:00+02:00;5;Salzburg;1720004;343055;1376949
2021-04-17T09:30:00+02:00;6;Steiermark;3416045;635057;2780988
2021-04-17T09:30:00+02:00;7;Tirol;2959494;801051;2158443
2021-04-17T09:30:00+02:00;8;Vorarlberg;1696208;218209;1477999
2021-04-17T09:30:00+02:00;9;Wien;5927405;2899267;3028138
2021-04-17T09:30:00+02:00;10;Österreich;28615969;7598679;21017290
2021-04-18T09:30:00+02:00;1;Burgenland;1163700;198548;965152
2021-04-18T09:30:00+02:00;2;Kärnten;1137889;267899;869990
2021-04-18T09:30:00+02:00;3;Niederösterreich;6575467;1592651;4982816
2021-04-18T09:30:00+02:00;4;Oberösterreich;4105264;657015;3448249
2021-04-18T09:30:00+02:00;5;Salzburg;1730191;344745;1385446
2021-04-18T09:30:00+02:00;6;Steiermark;3441078;636705;2804373
2021-04-18T09:30:00+02:00;7;Tirol;2972051;804834;2167217
2021-04-18T09:30:00+02:00;8;Vorarlberg;1714868;218906;1495962
2021-04-18T09:30:00+02:00;9;Wien;5983389;2929580;3053809
2021-04-18T09:30:00+02:00;10;Österreich;28823897;7650883;21173014
2021-04-19T09:30:00+02:00;1;Burgenland;1171788;199123;972665
2021-04-19T09:30:00+02:00;2;Kärnten;1138933;268927;870006
2021-04-19T09:30:00+02:00;3;Niederösterreich;6650205;1601724;5048481
2021-04-19T09:30:00+02:00;4;Oberösterreich;4134116;658828;3475288
2021-04-19T09:30:00+02:00;5;Salzburg;1731233;345588;1385645
2021-04-19T09:30:00+02:00;6;Steiermark;3442908;638535;2804373
2021-04-19T09:30:00+02:00;7;Tirol;2988916;809010;2179906
2021-04-19T09:30:00+02:00;8;Vorarlberg;1723374;219697;1503677
2021-04-19T09:30:00+02:00;9;Wien;6033077;2946385;3086692
2021-04-19T09:30:00+02:00;10;Österreich;29014550;7687817;21326733
2021-04-20T09:30:00+02:00;1;Burgenland;1189714;199704;990010
2021-04-20T09:30:00+02:00;2;Kärnten;1139991;269985;870006
2021-04-20T09:30:00+02:00;3;Niederösterreich;6730991;1608879;5122112
2021-04-20T09:30:00+02:00;4;Oberösterreich;4185277;661486;3523791
2021-04-20T09:30:00+02:00;5;Salzburg;1761166;347324;1413842
2021-04-20T09:30:00+02:00;6;Steiermark;3479116;642020;2837096
2021-04-20T09:30:00+02:00;7;Tirol;3003253;813888;2189365
2021-04-20T09:30:00+02:00;8;Vorarlberg;1749147;220584;1528563
2021-04-20T09:30:00+02:00;9;Wien;6096511;2984751;3111760
2021-04-20T09:30:00+02:00;10;Österreich;29335166;7748621;21586545
2021-04-21T09:30:00+02:00;1;Burgenland;1202809;200292;1002517
2021-04-21T09:30:00+02:00;2;Kärnten;1202792;272272;930520
2021-04-21T09:30:00+02:00;3;Niederösterreich;6790389;1616859;5173530
2021-04-21T09:30:00+02:00;4;Oberösterreich;4240167;664034;3576133
2021-04-21T09:30:00+02:00;5;Salzburg;1518728;348700;1170028
2021-04-21T09:30:00+02:00;6;Steiermark;3564343;646316;2918027
2021-04-21T09:30:00+02:00;7;Tirol;3129479;818608;2310871
2021-04-21T09:30:00+02:00;8;Vorarlberg;1773612;221386;1552226
2021-04-21T09:30:00+02:00;9;Wien;6175290;3044452;3130838
2021-04-21T09:30:00+02:00;10;Österreich;29597609;7832919;21764690
2021-04-22T09:30:00+02:00;1;Burgenland;1214446;200475;1013971
2021-04-22T09:30:00+02:00;2;Kärnten;1204349;273237;931112
2021-04-22T09:30:00+02:00;3;Niederösterreich;6876060;1628799;5247261
2021-04-22T09:30:00+02:00;4;Oberösterreich;4293292;666284;3627008
2021-04-22T09:30:00+02:00;5;Salzburg;1532902;350537;1182365
2021-04-22T09:30:00+02:00;6;Steiermark;3598517;648566;2949951
2021-04-22T09:30:00+02:00;7;Tirol;3142482;822862;2319620
2021-04-22T09:30:00+02:00;8;Vorarlberg;1798832;222269;1576563
2021-04-22T09:30:00+02:00;9;Wien;6244690;3092399;3152291
2021-04-22T09:30:00+02:00;10;Österreich;29905570;7905428;22000142
2021-04-23T09:30:00+02:00;1;Burgenland;1231480;201562;1029918
2021-04-23T09:30:00+02:00;2;Kärnten;1205413;274301;931112
2021-04-23T09:30:00+02:00;3;Niederösterreich;6935793;1637977;5297816
2021-04-23T09:30:00+02:00;4;Oberösterreich;4327249;669163;3658086
2021-04-23T09:30:00+02:00;5;Salzburg;1546930;352320;1194610
2021-04-23T09:30:00+02:00;6;Steiermark;3631516;651527;2979989
2021-04-23T09:30:00+02:00;7;Tirol;3156998;827453;2329545
2021-04-23T09:30:00+02:00;8;Vorarlberg;1825998;223510;1602488
2021-04-23T09:30:00+02:00;9;Wien;6325084;3150598;3174486
2021-04-23T09:30:00+02:00;10;Österreich;30186461;7988411;22198050
2021-04-24T09:30:00+02:00;1;Burgenland;1248424;203871;1044553
2021-04-24T09:30:00+02:00;2;Kärnten;1206460;275290;931170
2021-04-24T09:30:00+02:00;3;Niederösterreich;7012894;1647745;5365149
2021-04-24T09:30:00+02:00;4;Oberösterreich;4361230;671358;3689872
2021-04-24T09:30:00+02:00;5;Salzburg;1564143;353228;1210915
2021-04-24T09:30:00+02:00;6;Steiermark;3668920;653834;3015086
2021-04-24T09:30:00+02:00;7;Tirol;3172521;832538;2339983
2021-04-24T09:30:00+02:00;8;Vorarlberg;1862837;224465;1638372
2021-04-24T09:30:00+02:00;9;Wien;6391625;3192843;3198782
2021-04-24T09:30:00+02:00;10;Österreich;30489054;8055172;22433882
2021-04-25T09:30:00+02:00;1;Burgenland;1254623;204591;1050032
2021-04-25T09:30:00+02:00;2;Kärnten;1207518;276321;931197
2021-04-25T09:30:00+02:00;3;Niederösterreich;7058283;1656270;5402013
2021-04-25T09:30:00+02:00;4;Oberösterreich;4381457;673415;3708042
2021-04-25T09:30:00+02:00;5;Salzburg;1572482;354166;1218316
2021-04-25T09:30:00+02:00;6;Steiermark;3693524;655814;3037710
2021-04-25T09:30:00+02:00;7;Tirol;3184728;835790;2348938
2021-04-25T09:30:00+02:00;8;Vorarlberg;1883502;225483;1658019
2021-04-25T09:30:00+02:00;9;Wien;6452495;3235451;3217044
2021-04-25T09:30:00+02:00;10;Österreich;30688612;8117301;22571311
2021-04-26T09:30:00+02:00;1;Burgenland;1263842;205175;1058667
2021-04-26T09:30:00+02:00;2;Kärnten;1208264;277020;931244
2021-04-26T09:30:00+02:00;3;Niederösterreich;7094047;1663300;5430747
2021-04-26T09:30:00+02:00;4;Oberösterreich;4409268;675453;3733815
2021-04-26T09:30:00+02:00;5;Salzburg;1573674;355187;1218487
2021-04-26T09:30:00+02:00;6;Steiermark;3695653;657943;3037710
2021-04-26T09:30:00+02:00;7;Tirol;3201879;839405;2362474
2021-04-26T09:30:00+02:00;8;Vorarlberg;1895824;226219;1669605
2021-04-26T09:30:00+02:00;9;Wien;6493900;3251340;3242560
2021-04-26T09:30:00+02:00;10;Österreich;30836351;8151042;22685309
2021-04-27T09:30:00+02:00;1;Burgenland;1276822;205738;1071084
2021-04-27T09:30:00+02:00;2;Kärnten;1208866;277596;931270
2021-04-27T09:30:00+02:00;3;Niederösterreich;7154029;1668081;5485948
2021-04-27T09:30:00+02:00;4;Oberösterreich;4459169;677635;3781534
2021-04-27T09:30:00+02:00;5;Salzburg;1600367;356773;1243594
2021-04-27T09:30:00+02:00;6;Steiermark;3750005;660673;3089332
2021-04-27T09:30:00+02:00;7;Tirol;3328477;843909;2484568
2021-04-27T09:30:00+02:00;8;Vorarlberg;1924083;227129;1696954
2021-04-27T09:30:00+02:00;9;Wien;6561234;3298593;3262641
2021-04-27T09:30:00+02:00;10;Österreich;31263052;8216127;23046925
2021-04-28T09:30:00+02:00;1;Burgenland;1291681;206442;1085239
2021-04-28T09:30:00+02:00;2;Kärnten;1161128;280360;880768
2021-04-28T09:30:00+02:00;3;Niederösterreich;7208320;1674195;5534125
2021-04-28T09:30:00+02:00;4;Oberösterreich;4389973;680107;3709866
2021-04-28T09:30:00+02:00;5;Salzburg;1613703;358134;1255569
2021-04-28T09:30:00+02:00;6;Steiermark;3708703;663225;3045478
2021-04-28T09:30:00+02:00;7;Tirol;3340308;848486;2491822
2021-04-28T09:30:00+02:00;8;Vorarlberg;1950206;228431;1721775
2021-04-28T09:30:00+02:00;9;Wien;6653687;3367080;3286607
2021-04-28T09:30:00+02:00;10;Österreich;31317709;8306460;23011249
2021-04-29T09:30:00+02:00;1;Burgenland;1300878;207208;1093670
2021-04-29T09:30:00+02:00;2;Kärnten;1164016;281243;882773
2021-04-29T09:30:00+02:00;3;Niederösterreich;7268736;1684338;5584398
2021-04-29T09:30:00+02:00;4;Oberösterreich;4444219;682620;3761599
2021-04-29T09:30:00+02:00;5;Salzburg;1628525;359739;1268786
2021-04-29T09:30:00+02:00;6;Steiermark;3742240;668175;3074065
2021-04-29T09:30:00+02:00;7;Tirol;3361451;852764;2508687
2021-04-29T09:30:00+02:00;8;Vorarlberg;1976810;229525;1747285
2021-04-29T09:30:00+02:00;9;Wien;6702849;3395756;3307093
2021-04-29T09:30:00+02:00;10;Österreich;31589724;8361368;23228356
2021-04-30T09:30:00+02:00;1;Burgenland;1316161;208076;1108085
2021-04-30T09:30:00+02:00;2;Kärnten;1166943;282148;884795
2021-04-30T09:30:00+02:00;3;Niederösterreich;7308464;1692649;5615815
2021-04-30T09:30:00+02:00;4;Oberösterreich;4477521;685211;3792310
2021-04-30T09:30:00+02:00;5;Salzburg;1645400;361401;1283999
2021-04-30T09:30:00+02:00;6;Steiermark;3778686;671026;3107660
2021-04-30T09:30:00+02:00;7;Tirol;3374877;856819;2518058
2021-04-30T09:30:00+02:00;8;Vorarlberg;2004875;230807;1774068
2021-04-30T09:30:00+02:00;9;Wien;6819977;3482080;3337897
2021-04-30T09:30:00+02:00;10;Österreich;31892904;8470217;23422687
2021-05-01T09:30:00+02:00;1;Burgenland;1339910;208614;1131296
2021-05-01T09:30:00+02:00;2;Kärnten;1197118;283041;914077
2021-05-01T09:30:00+02:00;3;Niederösterreich;7373844;1701278;5672566
2021-05-01T09:30:00+02:00;4;Oberösterreich;4510075;687359;3822716
2021-05-01T09:30:00+02:00;5;Salzburg;1665986;362533;1303453
2021-05-01T09:30:00+02:00;6;Steiermark;3817717;673360;3144357
2021-05-01T09:30:00+02:00;7;Tirol;3388931;860969;2527962
2021-05-01T09:30:00+02:00;8;Vorarlberg;2043302;232607;1810695
2021-05-01T09:30:00+02:00;9;Wien;6891523;3527538;3363985
2021-05-01T09:30:00+02:00;10;Österreich;32228406;8537299;23691107
2021-05-02T09:30:00+02:00;1;Burgenland;1345076;209031;1136045
2021-05-02T09:30:00+02:00;2;Kärnten;1197990;283806;914184
2021-05-02T09:30:00+02:00;3;Niederösterreich;7405558;1708412;5697146
2021-05-02T09:30:00+02:00;4;Oberösterreich;4525493;689413;3836080
2021-05-02T09:30:00+02:00;5;Salzburg;1676569;363224;1313345
2021-05-02T09:30:00+02:00;6;Steiermark;3831785;675232;3156553
2021-05-02T09:30:00+02:00;7;Tirol;3400214;863723;2536491
2021-05-02T09:30:00+02:00;8;Vorarlberg;2063720;233550;1830170
2021-05-02T09:30:00+02:00;9;Wien;6937569;3551529;3386040
2021-05-02T09:30:00+02:00;10;Österreich;32383974;8577920;23806054
2021-05-03T09:30:00+02:00;1;Burgenland;1352004;209835;1142169
2021-05-03T09:30:00+02:00;2;Kärnten;1198413;284114;914299
2021-05-03T09:30:00+02:00;3;Niederösterreich;7446666;1715671;5730995
2021-05-03T09:30:00+02:00;4;Oberösterreich;4553813;690937;3862876
2021-05-03T09:30:00+02:00;5;Salzburg;1678692;364030;1314662
2021-05-03T09:30:00+02:00;6;Steiermark;3834070;677105;3156965
2021-05-03T09:30:00+02:00;7;Tirol;3418004;867595;2550409
2021-05-03T09:30:00+02:00;8;Vorarlberg;2076646;234456;1842190
2021-05-03T09:30:00+02:00;9;Wien;6937569;3551529;3386040
2021-05-03T09:30:00+02:00;10;Österreich;32495877;8595272;23900605
2021-05-04T09:30:00+02:00;1;Burgenland;1369564;210319;1159245
2021-05-04T09:30:00+02:00;2;Kärnten;1199456;285157;914299
2021-05-04T09:30:00+02:00;3;Niederösterreich;7496161;1721394;5774767
2021-05-04T09:30:00+02:00;4;Oberösterreich;4617613;693135;3924478
2021-05-04T09:30:00+02:00;5;Salzburg;1710527;365731;1344796
2021-05-04T09:30:00+02:00;6;Steiermark;3890389;680785;3209604
2021-05-04T09:30:00+02:00;7;Tirol;3430976;871421;2559555
2021-05-04T09:30:00+02:00;8;Vorarlberg;2105596;235303;1870293
2021-05-04T09:30:00+02:00;9;Wien;7075011;3617555;3457456
2021-05-04T09:30:00+02:00;10;Österreich;32895293;8680800;24214493
2021-05-05T09:30:00+02:00;1;Burgenland;1381715;211163;1170552
2021-05-05T09:30:00+02:00;2;Kärnten;1223220;287231;935989
2021-05-05T09:30:00+02:00;3;Niederösterreich;7562753;1726672;5836081
2021-05-05T09:30:00+02:00;4;Oberösterreich;4652977;696128;3956849
2021-05-05T09:30:00+02:00;5;Salzburg;1725579;367058;1358521
2021-05-05T09:30:00+02:00;6;Steiermark;3943277;684791;3258486
2021-05-05T09:30:00+02:00;7;Tirol;3444450;875919;2568531
2021-05-05T09:30:00+02:00;8;Vorarlberg;2131720;236622;1895098
2021-05-05T09:30:00+02:00;9;Wien;7175992;3691904;3484088
2021-05-05T09:30:00+02:00;10;Österreich;33241683;8777488;24464195
2021-05-06T09:30:00+02:00;1;Burgenland;1393362;211995;1181367
2021-05-06T09:30:00+02:00;2;Kärnten;1225046;288166;936880
2021-05-06T09:30:00+02:00;3;Niederösterreich;7634765;1735894;5898871
2021-05-06T09:30:00+02:00;4;Oberösterreich;4706863;698033;4008830
2021-05-06T09:30:00+02:00;5;Salzburg;1743147;368401;1374746
2021-05-06T09:30:00+02:00;6;Steiermark;3978238;688286;3289952
2021-05-06T09:30:00+02:00;7;Tirol;3585669;878024;2707645
2021-05-06T09:30:00+02:00;8;Vorarlberg;2158163;237500;1920663
2021-05-06T09:30:00+02:00;9;Wien;7277006;3756756;3520250
2021-05-06T09:30:00+02:00;10;Österreich;33702259;8863055;24839204
2021-05-07T09:30:00+02:00;1;Burgenland;1406623;212773;1193850
2021-05-07T09:30:00+02:00;2;Kärnten;1225824;288872;936952
2021-05-07T09:30:00+02:00;3;Niederösterreich;7695901;1743527;5952374
2021-05-07T09:30:00+02:00;4;Oberösterreich;4739112;700262;4038850
2021-05-07T09:30:00+02:00;5;Salzburg;1757951;369739;1388212
2021-05-07T09:30:00+02:00;6;Steiermark;4011351;690933;3320418
2021-05-07T09:30:00+02:00;7;Tirol;3601073;884909;2716164
2021-05-07T09:30:00+02:00;8;Vorarlberg;2185984;238900;1947084
2021-05-07T09:30:00+02:00;9;Wien;7366369;3818725;3547644
2021-05-07T09:30:00+02:00;10;Österreich;33990188;8948640;25041548
2021-05-08T09:30:00+02:00;1;Burgenland;1424333;213072;1211261
2021-05-08T09:30:00+02:00;2;Kärnten;1226748;289743;937005
2021-05-08T09:30:00+02:00;3;Niederösterreich;7760621;1751360;6009261
2021-05-08T09:30:00+02:00;4;Oberösterreich;4773735;702278;4071457
2021-05-08T09:30:00+02:00;5;Salzburg;1779423;370692;1408731
2021-05-08T09:30:00+02:00;6;Steiermark;4051628;693489;3358139
2021-05-08T09:30:00+02:00;7;Tirol;3613854;888965;2724889
2021-05-08T09:30:00+02:00;8;Vorarlberg;2226116;240459;1985657
2021-05-08T09:30:00+02:00;9;Wien;7443504;3868699;3574805
2021-05-08T09:30:00+02:00;10;Österreich;34299962;9018757;25281205
2021-05-09T09:30:00+02:00;1;Burgenland;1431182;214232;1216950
2021-05-09T09:30:00+02:00;2;Kärnten;1227262;290228;937034
2021-05-09T09:30:00+02:00;3;Niederösterreich;7804041;1758513;6045528
2021-05-09T09:30:00+02:00;4;Oberösterreich;4794344;703829;4090515
2021-05-09T09:30:00+02:00;5;Salzburg;1790871;371351;1419520
2021-05-09T09:30:00+02:00;6;Steiermark;4076337;694960;3381377
2021-05-09T09:30:00+02:00;7;Tirol;3623459;891351;2732108
2021-05-09T09:30:00+02:00;8;Vorarlberg;2250566;241525;2009041
2021-05-09T09:30:00+02:00;9;Wien;7506115;3912404;3593711
2021-05-09T09:30:00+02:00;10;Österreich;34504177;9078393;25425784
2021-05-10T09:30:00+02:00;1;Burgenland;1439691;214731;1224960
2021-05-10T09:30:00+02:00;2;Kärnten;1227666;290578;937088
2021-05-10T09:30:00+02:00;3;Niederösterreich;7837987;1764758;6073229
2021-05-10T09:30:00+02:00;4;Oberösterreich;4818439;704919;4113520
2021-05-10T09:30:00+02:00;5;Salzburg;1794193;372088;1422105
2021-05-10T09:30:00+02:00;6;Steiermark;4078199;696822;3381377
2021-05-10T09:30:00+02:00;7;Tirol;3636270;893835;2742435
2021-05-10T09:30:00+02:00;8;Vorarlberg;2263315;242150;2021165
2021-05-10T09:30:00+02:00;9;Wien;7543873;3925691;3618182
2021-05-10T09:30:00+02:00;10;Österreich;34639633;9105572;25534061
2021-05-11T09:30:00+02:00;1;Burgenland;1455545;215140;1240405
2021-05-11T09:30:00+02:00;2;Kärnten;1229754;291622;938132
2021-05-11T09:30:00+02:00;3;Niederösterreich;7907389;1769112;6138277
2021-05-11T09:30:00+02:00;4;Oberösterreich;4876182;706790;4169392
2021-05-11T09:30:00+02:00;5;Salzburg;1828764;372995;1455769
2021-05-11T09:30:00+02:00;6;Steiermark;4129903;699906;3429997
2021-05-11T09:30:00+02:00;7;Tirol;3646781;896419;2750362
2021-05-11T09:30:00+02:00;8;Vorarlberg;2291760;243092;2048668
2021-05-11T09:30:00+02:00;9;Wien;7637152;3984456;3652696
2021-05-11T09:30:00+02:00;10;Österreich;35003230;9179532;25823698
2021-05-12T09:30:00+02:00;1;Burgenland;1467008;215959;1251049
2021-05-12T09:30:00+02:00;2;Kärnten;1309335;293731;1015604
2021-05-12T09:30:00+02:00;3;Niederösterreich;7966852;1774254;6192598
2021-05-12T09:30:00+02:00;4;Oberösterreich;4909829;708501;4201328
2021-05-12T09:30:00+02:00;5;Salzburg;1844034;374117;1469917
2021-05-12T09:30:00+02:00;6;Steiermark;4179323;703401;3475922
2021-05-12T09:30:00+02:00;7;Tirol;3657922;900261;2757661
2021-05-12T09:30:00+02:00;8;Vorarlberg;2313789;244115;2069674
2021-05-12T09:30:00+02:00;9;Wien;7734926;4054658;3680268
2021-05-12T09:30:00+02:00;10;Österreich;35383018;9268997;26114021
2021-05-13T09:30:00+02:00;1;Burgenland;1478247;216436;1261811
2021-05-13T09:30:00+02:00;2;Kärnten;1311192;294320;1016872
2021-05-13T09:30:00+02:00;3;Niederösterreich;8024719;1781644;6243075
2021-05-13T09:30:00+02:00;4;Oberösterreich;4959174;710043;4249131
2021-05-13T09:30:00+02:00;5;Salzburg;1862735;375873;1486862
2021-05-13T09:30:00+02:00;6;Steiermark;4219812;706135;3513677
2021-05-13T09:30:00+02:00;7;Tirol;3779126;903563;2875563
2021-05-13T09:30:00+02:00;8;Vorarlberg;2341732;245298;2096434
2021-05-13T09:30:00+02:00;9;Wien;7821975;4115874;3706101
2021-05-13T09:30:00+02:00;10;Österreich;35798712;9349186;26449526
2021-05-14T09:30:00+02:00;1;Burgenland;1486326;217283;1269043
2021-05-14T09:30:00+02:00;2;Kärnten;1311813;294911;1016902
2021-05-14T09:30:00+02:00;3;Niederösterreich;8055822;1787701;6268121
2021-05-14T09:30:00+02:00;4;Oberösterreich;4978489;711404;4267085
2021-05-14T09:30:00+02:00;5;Salzburg;1870174;376735;1493439
2021-05-14T09:30:00+02:00;6;Steiermark;4221618;707667;3513951
2021-05-14T09:30:00+02:00;7;Tirol;3790391;905979;2884412
2021-05-14T09:30:00+02:00;8;Vorarlberg;2358960;246106;2112854
2021-05-14T09:30:00+02:00;9;Wien;7866320;4136206;3730114
2021-05-14T09:30:00+02:00;10;Österreich;35939913;9383992;26555921
2021-05-15T09:30:00+02:00;1;Burgenland;1504261;217701;1286560
2021-05-15T09:30:00+02:00;2;Kärnten;1312408;295474;1016934
2021-05-15T09:30:00+02:00;3;Niederösterreich;8113423;1794442;6318981
2021-05-15T09:30:00+02:00;4;Oberösterreich;5009678;712844;4296834
2021-05-15T09:30:00+02:00;5;Salzburg;1889696;377202;1512494
2021-05-15T09:30:00+02:00;6;Steiermark;4262577;709788;3552789
2021-05-15T09:30:00+02:00;7;Tirol;3801169;908432;2892737
2021-05-15T09:30:00+02:00;8;Vorarlberg;2391484;246827;2144657
2021-05-15T09:30:00+02:00;9;Wien;7932899;4175585;3757314
2021-05-15T09:30:00+02:00;10;Österreich;36217595;9438295;26779300
2021-05-16T09:30:00+02:00;1;Burgenland;1509785;218160;1291625
2021-05-16T09:30:00+02:00;2;Kärnten;1312915;295960;1016955
2021-05-16T09:30:00+02:00;3;Niederösterreich;8147830;1798439;6349391
2021-05-16T09:30:00+02:00;4;Oberösterreich;5026717;714031;4312686
2021-05-16T09:30:00+02:00;5;Salzburg;1898269;377747;1520522
2021-05-16T09:30:00+02:00;6;Steiermark;4285484;711316;3574168
2021-05-16T09:30:00+02:00;7;Tirol;3809353;910463;2898890
2021-05-16T09:30:00+02:00;8;Vorarlberg;2410258;247869;2162389
2021-05-16T09:30:00+02:00;9;Wien;7992464;4215933;3776531
2021-05-16T09:30:00+02:00;10;Österreich;36393075;9489918;26903157
2021-05-17T09:30:00+02:00;1;Burgenland;1517991;218629;1299362
2021-05-17T09:30:00+02:00;2;Kärnten;1313439;296449;1016990
2021-05-17T09:30:00+02:00;3;Niederösterreich;8178563;1802952;6375611
2021-05-17T09:30:00+02:00;4;Oberösterreich;5051147;715205;4335942
2021-05-17T09:30:00+02:00;5;Salzburg;1898993;378296;1520697
2021-05-17T09:30:00+02:00;6;Steiermark;4287187;713019;3574168
2021-05-17T09:30:00+02:00;7;Tirol;3822593;912487;2910106
2021-05-17T09:30:00+02:00;8;Vorarlberg;2417817;248380;2169437
2021-05-17T09:30:00+02:00;9;Wien;8043717;4238580;3805137
2021-05-17T09:30:00+02:00;10;Österreich;36531447;9523997;27007450
2021-05-18T09:30:00+02:00;1;Burgenland;1533956;219156;1314800
2021-05-18T09:30:00+02:00;2;Kärnten;1314141;297084;1017057
2021-05-18T09:30:00+02:00;3;Niederösterreich;8235423;1807103;6428320
2021-05-18T09:30:00+02:00;4;Oberösterreich;5094728;716639;4378089
2021-05-18T09:30:00+02:00;5;Salzburg;1927721;379229;1548492
2021-05-18T09:30:00+02:00;6;Steiermark;4336839;714486;3622353
2021-05-18T09:30:00+02:00;7;Tirol;3832350;915335;2917015
2021-05-18T09:30:00+02:00;8;Vorarlberg;2440424;249161;2191263
2021-05-18T09:30:00+02:00;9;Wien;8125236;4297285;3827951
2021-05-18T09:30:00+02:00;10;Österreich;36840818;9595478;27245340
2021-05-19T09:30:00+02:00;1;Burgenland;1548756;219627;1329129
2021-05-19T09:30:00+02:00;2;Kärnten;1350222;297511;1052711
2021-05-19T09:30:00+02:00;3;Niederösterreich;8316175;1814099;6502076
2021-05-19T09:30:00+02:00;4;Oberösterreich;5136216;718680;4417536
2021-05-19T09:30:00+02:00;5;Salzburg;1943649;380503;1563146
2021-05-19T09:30:00+02:00;6;Steiermark;4399664;717418;3682246
2021-05-19T09:30:00+02:00;7;Tirol;3845363;918350;2927013
2021-05-19T09:30:00+02:00;8;Vorarlberg;2458279;250017;2208262
2021-05-19T09:30:00+02:00;9;Wien;8239058;4385268;3853790
2021-05-19T09:30:00+02:00;10;Österreich;37237382;9701473;27535909
2021-05-20T09:30:00+02:00;1;Burgenland;1563307;220246;1343061
2021-05-20T09:30:00+02:00;2;Kärnten;1352816;299252;1053564
2021-05-20T09:30:00+02:00;3;Niederösterreich;8400686;1823319;6577367
2021-05-20T09:30:00+02:00;4;Oberösterreich;5202123;719694;4482429
2021-05-20T09:30:00+02:00;5;Salzburg;1968147;381421;1586726
2021-05-20T09:30:00+02:00;6;Steiermark;4456349;719508;3736841
2021-05-20T09:30:00+02:00;7;Tirol;3862170;922863;2939307
2021-05-20T09:30:00+02:00;8;Vorarlberg;2480216;250658;2229558
2021-05-20T09:30:00+02:00;9;Wien;8340220;4447794;3892426
2021-05-20T09:30:00+02:00;10;Österreich;37626034;9784755;27841279
2021-05-21T09:30:00+02:00;1;Burgenland;1574418;220906;1353512
2021-05-21T09:30:00+02:00;2;Kärnten;1359493;299577;1059916
2021-05-21T09:30:00+02:00;3;Niederösterreich;8442978;1831241;6611737
2021-05-21T09:30:00+02:00;4;Oberösterreich;5242055;721057;4520998
2021-05-21T09:30:00+02:00;5;Salzburg;1987040;383055;1603985
2021-05-21T09:30:00+02:00;6;Steiermark;4498321;721208;3777113
2021-05-21T09:30:00+02:00;7;Tirol;3975707;925845;3049862
2021-05-21T09:30:00+02:00;8;Vorarlberg;2498381;251478;2246903
2021-05-21T09:30:00+02:00;9;Wien;8471793;4542807;3928986
2021-05-21T09:30:00+02:00;10;Österreich;38050186;9897174;28153012
2021-05-22T09:30:00+02:00;1;Burgenland;1602084;221489;1380595
2021-05-22T09:30:00+02:00;2;Kärnten;1360969;300069;1060900
2021-05-22T09:30:00+02:00;3;Niederösterreich;8558956;1837419;6721537
2021-05-22T09:30:00+02:00;4;Oberösterreich;5296575;722160;4574415
2021-05-22T09:30:00+02:00;5;Salzburg;2019534;383519;1636015
2021-05-22T09:30:00+02:00;6;Steiermark;4570020;722943;3847077
2021-05-22T09:30:00+02:00;7;Tirol;3993726;928984;3064742
2021-05-22T09:30:00+02:00;8;Vorarlberg;2529280;252204;2277076
2021-05-22T09:30:00+02:00;9;Wien;8598393;4623577;3974816
2021-05-22T09:30:00+02:00;10;Österreich;38529537;9992364;28537173
2021-05-23T09:30:00+02:00;1;Burgenland;1614604;221583;1393021
2021-05-23T09:30:00+02:00;2;Kärnten;1361273;300350;1060923
2021-05-23T09:30:00+02:00;3;Niederösterreich;8631708;1842380;6789328
2021-05-23T09:30:00+02:00;4;Oberösterreich;5337719;723022;4614697
2021-05-23T09:30:00+02:00;5;Salzburg;2042689;383947;1658742
2021-05-23T09:30:00+02:00;6;Steiermark;4623087;723899;3899188
2021-05-23T09:30:00+02:00;7;Tirol;4011721;931207;3080514
2021-05-23T09:30:00+02:00;8;Vorarlberg;2548467;252951;2295516
2021-05-23T09:30:00+02:00;9;Wien;8706441;4687627;4018814
2021-05-23T09:30:00+02:00;10;Österreich;38877709;10066966;28810743
2021-05-24T09:30:00+02:00;1;Burgenland;1626356;222039;1404317
2021-05-24T09:30:00+02:00;2;Kärnten;1361533;300599;1060934
2021-05-24T09:30:00+02:00;3;Niederösterreich;8674411;1846540;6827871
2021-05-24T09:30:00+02:00;4;Oberösterreich;5369323;724205;4645118
2021-05-24T09:30:00+02:00;5;Salzburg;2044067;384270;1659797
2021-05-24T09:30:00+02:00;6;Steiermark;4642645;724823;3917822
2021-05-24T09:30:00+02:00;7;Tirol;4030998;933202;3097796
2021-05-24T09:30:00+02:00;8;Vorarlberg;2556281;253591;2302690
2021-05-24T09:30:00+02:00;9;Wien;8783610;4722279;4061331
2021-05-24T09:30:00+02:00;10;Österreich;39089224;10111548;28977676
2021-05-25T09:30:00+02:00;1;Burgenland;1637958;222430;1415528
2021-05-25T09:30:00+02:00;2;Kärnten;1364105;303164;1060941
2021-05-25T09:30:00+02:00;3;Niederösterreich;8727483;1851169;6876314
2021-05-25T09:30:00+02:00;4;Oberösterreich;5456970;725145;4731825
2021-05-25T09:30:00+02:00;5;Salzburg;2060793;384711;1676082
2021-05-25T09:30:00+02:00;6;Steiermark;4744944;725676;4019268
2021-05-25T09:30:00+02:00;7;Tirol;4050839;935504;3115335
2021-05-25T09:30:00+02:00;8;Vorarlberg;2568768;254068;2314700
2021-05-25T09:30:00+02:00;9;Wien;8859658;4748477;4111181
2021-05-25T09:30:00+02:00;10;Österreich;39471518;10150344;29321174
2021-05-26T09:30:00+02:00;1;Burgenland;1653636;222973;1430663
2021-05-26T09:30:00+02:00;2;Kärnten;1397311;303562;1093749
2021-05-26T09:30:00+02:00;3;Niederösterreich;8809015;1855373;6953642
2021-05-26T09:30:00+02:00;4;Oberösterreich;5482943;726616;4756327
2021-05-26T09:30:00+02:00;5;Salzburg;2105841;386013;1719828
2021-05-26T09:30:00+02:00;6;Steiermark;4832028;727554;4104474
2021-05-26T09:30:00+02:00;7;Tirol;4065841;938024;3127817
2021-05-26T09:30:00+02:00;8;Vorarlberg;2588098;254567;2333531
2021-05-26T09:30:00+02:00;9;Wien;8979797;4824857;4154940
2021-05-26T09:30:00+02:00;10;Österreich;39914510;10239539;29674971
2021-05-27T09:30:00+02:00;1;Burgenland;1665407;223639;1441768
2021-05-27T09:30:00+02:00;2;Kärnten;1465110;304252;1160858
2021-05-27T09:30:00+02:00;3;Niederösterreich;8870648;1859266;7011382
2021-05-27T09:30:00+02:00;4;Oberösterreich;5563074;727860;4835214
2021-05-27T09:30:00+02:00;5;Salzburg;2122292;387267;1735025
2021-05-27T09:30:00+02:00;6;Steiermark;4904697;729467;4175230
2021-05-27T09:30:00+02:00;7;Tirol;4142109;940911;3201198
2021-05-27T09:30:00+02:00;8;Vorarlberg;2603856;255249;2348607
2021-05-27T09:30:00+02:00;9;Wien;9119645;4929756;4189889
2021-05-27T09:30:00+02:00;10;Österreich;40456838;10357667;30099171
2021-05-28T09:30:00+02:00;1;Burgenland;1681489;224100;1457389
2021-05-28T09:30:00+02:00;2;Kärnten;1465132;304252;1160880
2021-05-28T09:30:00+02:00;3;Niederösterreich;8927523;1865232;7062291
2021-05-28T09:30:00+02:00;4;Oberösterreich;5592840;729026;4863814
2021-05-28T09:30:00+02:00;5;Salzburg;2137210;388655;1748555
2021-05-28T09:30:00+02:00;6;Steiermark;4973341;730874;4242467
2021-05-28T09:30:00+02:00;7;Tirol;4155773;943641;3212132
2021-05-28T09:30:00+02:00;8;Vorarlberg;2619597;256014;2363583
2021-05-28T09:30:00+02:00;9;Wien;9236221;5012425;4223796
2021-05-28T09:30:00+02:00;10;Österreich;40789126;10454219;30334907
2021-05-29T09:30:00+02:00;1;Burgenland;1704353;225069;1479284
2021-05-29T09:30:00+02:00;2;Kärnten;1466702;305042;1161660
2021-05-29T09:30:00+02:00;3;Niederösterreich;9006552;1871063;7135489
2021-05-29T09:30:00+02:00;4;Oberösterreich;5638147;730166;4907981
2021-05-29T09:30:00+02:00;5;Salzburg;2181257;389366;1791891
2021-05-29T09:30:00+02:00;6;Steiermark;5063656;732162;4331494
2021-05-29T09:30:00+02:00;7;Tirol;4173329;946385;3226944
2021-05-29T09:30:00+02:00;8;Vorarlberg;2645775;256764;2389011
2021-05-29T09:30:00+02:00;9;Wien;9344468;5076086;4268382
2021-05-29T09:30:00+02:00;10;Österreich;41224239;10532103;30692136
2021-05-30T09:30:00+02:00;1;Burgenland;1718043;225702;1492341
2021-05-30T09:30:00+02:00;2;Kärnten;1466953;305275;1161678
2021-05-30T09:30:00+02:00;3;Niederösterreich;9066796;1876057;7190739
2021-05-30T09:30:00+02:00;4;Oberösterreich;5638796;730704;4908092
2021-05-30T09:30:00+02:00;5;Salzburg;2222303;389770;1832533
2021-05-30T09:30:00+02:00;6;Steiermark;5132802;732974;4399828
2021-05-30T09:30:00+02:00;7;Tirol;4188903;948115;3240788
2021-05-30T09:30:00+02:00;8;Vorarlberg;2660255;257316;2402939
2021-05-30T09:30:00+02:00;9;Wien;9468873;5157057;4311816
2021-05-30T09:30:00+02:00;10;Österreich;41563724;10622970;30940754
2021-05-31T09:30:00+02:00;1;Burgenland;1727866;226111;1501755
2021-05-31T09:30:00+02:00;2;Kärnten;1467424;305746;1161678
2021-05-31T09:30:00+02:00;3;Niederösterreich;9104097;1880120;7223977
2021-05-31T09:30:00+02:00;4;Oberösterreich;5639735;731444;4908291
2021-05-31T09:30:00+02:00;5;Salzburg;2248912;390140;1858772
2021-05-31T09:30:00+02:00;6;Steiermark;5179808;734855;4444953
2021-05-31T09:30:00+02:00;7;Tirol;4206311;950244;3256067
2021-05-31T09:30:00+02:00;8;Vorarlberg;2666184;257885;2408299
2021-05-31T09:30:00+02:00;9;Wien;9535872;5183239;4352633
2021-05-31T09:30:00+02:00;10;Österreich;41776209;10659784;31116425
2021-06-01T09:30:00+02:00;1;Burgenland;1743240;226620;1516620
2021-06-01T09:30:00+02:00;2;Kärnten;1467836;306158;1161678
2021-06-01T09:30:00+02:00;3;Niederösterreich;9165500;1883723;7281777
2021-06-01T09:30:00+02:00;4;Oberösterreich;5648327;732550;4915777
2021-06-01T09:30:00+02:00;5;Salzburg;2292718;391139;1901579
2021-06-01T09:30:00+02:00;6;Steiermark;5254136;735548;4518588
2021-06-01T09:30:00+02:00;7;Tirol;4220340;952800;3267540
2021-06-01T09:30:00+02:00;8;Vorarlberg;2681953;258478;2423475
2021-06-01T09:30:00+02:00;9;Wien;9648499;5257940;4390559
2021-06-01T09:30:00+02:00;10;Österreich;42122549;10744956;31377593
2021-06-02T09:30:00+02:00;1;Burgenland;1755748;227278;1528470
2021-06-02T09:30:00+02:00;2;Kärnten;1513700;306597;1207103
2021-06-02T09:30:00+02:00;3;Niederösterreich;9215471;1887489;7327982
2021-06-02T09:30:00+02:00;4;Oberösterreich;6186623;733769;5452854
2021-06-02T09:30:00+02:00;5;Salzburg;2327933;392256;1935677
2021-06-02T09:30:00+02:00;6;Steiermark;5334198;737960;4596238
2021-06-02T09:30:00+02:00;7;Tirol;4234223;955227;3278996
2021-06-02T09:30:00+02:00;8;Vorarlberg;2693527;259127;2434400
2021-06-02T09:30:00+02:00;9;Wien;9786653;5355498;4431155
2021-06-02T09:30:00+02:00;10;Österreich;43048076;10855201;32192875
2021-06-03T09:30:00+02:00;1;Burgenland;1771077;227923;1543154
2021-06-03T09:30:00+02:00;2;Kärnten;1515354;306993;1208361
2021-06-03T09:30:00+02:00;3;Niederösterreich;9296476;1893055;7403421
2021-06-03T09:30:00+02:00;4;Oberösterreich;6347909;734739;5613170
2021-06-03T09:30:00+02:00;5;Salzburg;2375279;393250;1982029
2021-06-03T09:30:00+02:00;6;Steiermark;5407581;738952;4668629
2021-06-03T09:30:00+02:00;7;Tirol;4381873;957531;3424342
2021-06-03T09:30:00+02:00;8;Vorarlberg;2713592;259566;2454026
2021-06-03T09:30:00+02:00;9;Wien;9919962;5442983;4476979
2021-06-03T09:30:00+02:00;10;Österreich;43729103;10954992;32774111
2021-06-04T09:30:00+02:00;1;Burgenland;1796354;228307;1568047
2021-06-04T09:30:00+02:00;2;Kärnten;1515535;307174;1208361
2021-06-04T09:30:00+02:00;3;Niederösterreich;9343787;1897339;7446448
2021-06-04T09:30:00+02:00;4;Oberösterreich;6416222;735603;5680619
2021-06-04T09:30:00+02:00;5;Salzburg;2415076;393597;2021479
2021-06-04T09:30:00+02:00;6;Steiermark;5480189;745053;4735136
2021-06-04T09:30:00+02:00;7;Tirol;4401121;959640;3441481
2021-06-04T09:30:00+02:00;8;Vorarlberg;2723752;259862;2463890
2021-06-04T09:30:00+02:00;9;Wien;10018309;5486686;4531623
2021-06-04T09:30:00+02:00;10;Österreich;44110345;11013261;33097084
2021-06-05T09:30:00+02:00;1;Burgenland;1820591;228711;1591880
2021-06-05T09:30:00+02:00;2;Kärnten;1621778;307174;1314604
2021-06-05T09:30:00+02:00;3;Niederösterreich;9420683;1902479;7518204
2021-06-05T09:30:00+02:00;4;Oberösterreich;6600593;736420;5864173
2021-06-05T09:30:00+02:00;5;Salzburg;2473506;394563;2078943
2021-06-05T09:30:00+02:00;6;Steiermark;5608953;746862;4862091
2021-06-05T09:30:00+02:00;7;Tirol;4418730;961625;3457105
2021-06-05T09:30:00+02:00;8;Vorarlberg;2744656;260277;2484379
2021-06-05T09:30:00+02:00;9;Wien;10149504;5554214;4595290
2021-06-05T09:30:00+02:00;10;Österreich;44858994;11092325;33766669
2021-06-06T09:30:00+02:00;1;Burgenland;1837099;229210;1607889
2021-06-06T09:30:00+02:00;2;Kärnten;1622297;307693;1314604
2021-06-06T09:30:00+02:00;3;Niederösterreich;9471896;1906133;7565763
2021-06-06T09:30:00+02:00;4;Oberösterreich;6700206;736844;5963362
2021-06-06T09:30:00+02:00;5;Salzburg;2520970;394913;2126057
2021-06-06T09:30:00+02:00;6;Steiermark;5692157;747278;4944879
2021-06-06T09:30:00+02:00;7;Tirol;4436149;963283;3472866
2021-06-06T09:30:00+02:00;8;Vorarlberg;2756379;260685;2495694
2021-06-06T09:30:00+02:00;9;Wien;10241226;5611853;4629373
2021-06-06T09:30:00+02:00;10;Österreich;45278379;11157892;34120487
2021-06-07T09:30:00+02:00;1;Burgenland;1850359;229563;1620796
2021-06-07T09:30:00+02:00;2;Kärnten;1622432;307828;1314604
2021-06-07T09:30:00+02:00;3;Niederösterreich;9505891;1909945;7595946
2021-06-07T09:30:00+02:00;4;Oberösterreich;6779215;737601;6041614
2021-06-07T09:30:00+02:00;5;Salzburg;2548188;395212;2152976
2021-06-07T09:30:00+02:00;6;Steiermark;5743459;747747;4995712
2021-06-07T09:30:00+02:00;7;Tirol;4453610;965177;3488433
2021-06-07T09:30:00+02:00;8;Vorarlberg;2761583;261146;2500437
2021-06-07T09:30:00+02:00;9;Wien;10306257;5630454;4675803
2021-06-07T09:30:00+02:00;10;Österreich;45570994;11184673;34386321
2021-06-08T09:30:00+02:00;1;Burgenland;1865108;230133;1634975
2021-06-08T09:30:00+02:00;2;Kärnten;1622983;308379;1314604
2021-06-08T09:30:00+02:00;3;Niederösterreich;9554145;1913010;7641135
2021-06-08T09:30:00+02:00;4;Oberösterreich;6851691;738569;6113122
2021-06-08T09:30:00+02:00;5;Salzburg;2592217;396310;2195907
2021-06-08T09:30:00+02:00;6;Steiermark;5814485;750363;5064122
2021-06-08T09:30:00+02:00;7;Tirol;4464243;967196;3497047
2021-06-08T09:30:00+02:00;8;Vorarlberg;2773203;261465;2511738
2021-06-08T09:30:00+02:00;9;Wien;10444930;5709870;4735060
2021-06-08T09:30:00+02:00;10;Österreich;45983005;11275295;34707710
2021-06-09T09:30:00+02:00;1;Burgenland;1874198;230737;1643461
2021-06-09T09:30:00+02:00;2;Kärnten;1623397;308793;1314604
2021-06-09T09:30:00+02:00;3;Niederösterreich;9585653;1916292;7669361
2021-06-09T09:30:00+02:00;4;Oberösterreich;6916778;739450;6177328
2021-06-09T09:30:00+02:00;5;Salzburg;2617680;397477;2220203
2021-06-09T09:30:00+02:00;6;Steiermark;5888257;752543;5135714
2021-06-09T09:30:00+02:00;7;Tirol;4582056;968958;3613098
2021-06-09T09:30:00+02:00;8;Vorarlberg;2781377;261933;2519444
2021-06-09T09:30:00+02:00;9;Wien;10556770;5789102;4767668
2021-06-09T09:30:00+02:00;10;Österreich;46426166;11365285;35060881
2021-06-10T09:30:00+02:00;1;Burgenland;1893858;230936;1662922
2021-06-10T09:30:00+02:00;2;Kärnten;1804702;311115;1493587
2021-06-10T09:30:00+02:00;3;Niederösterreich;9623375;1921197;7702178
2021-06-10T09:30:00+02:00;4;Oberösterreich;6985491;740212;6245279
2021-06-10T09:30:00+02:00;5;Salzburg;2645894;398287;2247607
2021-06-10T09:30:00+02:00;6;Steiermark;5946210;753305;5192905
2021-06-10T09:30:00+02:00;7;Tirol;4590996;970419;3620577
2021-06-10T09:30:00+02:00;8;Vorarlberg;2792740;262234;2530506
2021-06-10T09:30:00+02:00;9;Wien;10659403;5858801;4800602
2021-06-10T09:30:00+02:00;10;Österreich;46942669;11446506;35496163
2021-06-11T09:30:00+02:00;1;Burgenland;1905410;231410;1674000
2021-06-11T09:30:00+02:00;2;Kärnten;1804890;311303;1493587
2021-06-11T09:30:00+02:00;3;Niederösterreich;9665399;1926378;7739021
2021-06-11T09:30:00+02:00;4;Oberösterreich;7048854;740942;6307912
2021-06-11T09:30:00+02:00;5;Salzburg;2672794;399355;2273439
2021-06-11T09:30:00+02:00;6;Steiermark;6000972;754970;5246002
2021-06-11T09:30:00+02:00;7;Tirol;4599197;971552;3627645
2021-06-11T09:30:00+02:00;8;Vorarlberg;2801409;262520;2538889
2021-06-11T09:30:00+02:00;9;Wien;10769255;5933991;4835264
2021-06-11T09:30:00+02:00;10;Österreich;47268180;11532421;35735759
2021-06-12T09:30:00+02:00;1;Burgenland;1930444;231680;1698764
2021-06-12T09:30:00+02:00;2;Kärnten;1805034;311447;1493587
2021-06-12T09:30:00+02:00;3;Niederösterreich;9715155;1930385;7784770
2021-06-12T09:30:00+02:00;4;Oberösterreich;7145413;741611;6403802
2021-06-12T09:30:00+02:00;5;Salzburg;2712073;399772;2312301
2021-06-12T09:30:00+02:00;6;Steiermark;6091501;755827;5335674
2021-06-12T09:30:00+02:00;7;Tirol;4611397;973256;3638141
2021-06-12T09:30:00+02:00;8;Vorarlberg;2818988;262720;2556268
2021-06-12T09:30:00+02:00;9;Wien;10895429;5961239;4934190
2021-06-12T09:30:00+02:00;10;Österreich;47725434;11567937;36157497
2021-06-13T09:30:00+02:00;1;Burgenland;1944166;231737;1712429
2021-06-13T09:30:00+02:00;2;Kärnten;1805141;311554;1493587
2021-06-13T09:30:00+02:00;3;Niederösterreich;9797671;1933817;7863854
2021-06-13T09:30:00+02:00;4;Oberösterreich;7240165;742072;6498093
2021-06-13T09:30:00+02:00;5;Salzburg;2751407;400060;2351347
2021-06-13T09:30:00+02:00;6;Steiermark;6171433;756336;5415097
2021-06-13T09:30:00+02:00;7;Tirol;4620870;973869;3647001
2021-06-13T09:30:00+02:00;8;Vorarlberg;2828315;262903;2565412
2021-06-13T09:30:00+02:00;9;Wien;10986811;6010976;4975835
2021-06-13T09:30:00+02:00;10;Österreich;48145979;11623324;36522655
2021-06-14T09:30:00+02:00;1;Burgenland;1959166;231941;1727225
2021-06-14T09:30:00+02:00;2;Kärnten;1805558;311971;1493587
2021-06-14T09:30:00+02:00;3;Niederösterreich;9832538;1937064;7895474
2021-06-14T09:30:00+02:00;4;Oberösterreich;7331751;742649;6589102
2021-06-14T09:30:00+02:00;5;Salzburg;2782675;400246;2382429
2021-06-14T09:30:00+02:00;6;Steiermark;6235105;757541;5477564
2021-06-14T09:30:00+02:00;7;Tirol;4631104;974562;3656542
2021-06-14T09:30:00+02:00;8;Vorarlberg;2832446;263227;2569219
2021-06-14T09:30:00+02:00;9;Wien;11048387;6030153;5018234
2021-06-14T09:30:00+02:00;10;Österreich;48458730;11649354;36809376
2021-06-15T09:30:00+02:00;1;Burgenland;1972399;232155;1740244
2021-06-15T09:30:00+02:00;2;Kärnten;1805701;312114;1493587
2021-06-15T09:30:00+02:00;3;Niederösterreich;9872454;1939447;7933007
2021-06-15T09:30:00+02:00;4;Oberösterreich;7391731;743284;6648447
2021-06-15T09:30:00+02:00;5;Salzburg;2829182;401152;2428030
2021-06-15T09:30:00+02:00;6;Steiermark;6302992;758805;5544187
2021-06-15T09:30:00+02:00;7;Tirol;4639446;975972;3663474
2021-06-15T09:30:00+02:00;8;Vorarlberg;2842061;263438;2578623
2021-06-15T09:30:00+02:00;9;Wien;11157197;6104014;5053183
2021-06-15T09:30:00+02:00;10;Österreich;48813163;11730381;37082782
2021-06-16T09:30:00+02:00;1;Burgenland;1983066;232349;1750717
2021-06-16T09:30:00+02:00;2;Kärnten;1806568;312746;1493822
2021-06-16T09:30:00+02:00;3;Niederösterreich;9956708;1942883;8013825
2021-06-16T09:30:00+02:00;4;Oberösterreich;7457570;744110;6713460
2021-06-16T09:30:00+02:00;5;Salzburg;2855325;402200;2453125
2021-06-16T09:30:00+02:00;6;Steiermark;6356020;759726;5596294
2021-06-16T09:30:00+02:00;7;Tirol;4645623;977135;3668488
2021-06-16T09:30:00+02:00;8;Vorarlberg;2849408;263729;2585679
2021-06-16T09:30:00+02:00;9;Wien;11257571;6173260;5084311
2021-06-16T09:30:00+02:00;10;Österreich;49167859;11808138;37359721
2021-06-17T09:30:00+02:00;1;Burgenland;1995247;232400;1762847
2021-06-17T09:30:00+02:00;2;Kärnten;1975056;314844;1660212
2021-06-17T09:30:00+02:00;3;Niederösterreich;10028225;1947553;8080672
2021-06-17T09:30:00+02:00;4;Oberösterreich;7528779;744746;6784033
2021-06-17T09:30:00+02:00;5;Salzburg;2884812;403031;2481781
2021-06-17T09:30:00+02:00;6;Steiermark;6407654;760738;5646916
2021-06-17T09:30:00+02:00;7;Tirol;4653426;978643;3674783
2021-06-17T09:30:00+02:00;8;Vorarlberg;2858657;263916;2594741
2021-06-17T09:30:00+02:00;9;Wien;11362050;6246701;5115349
2021-06-17T09:30:00+02:00;10;Österreich;49693906;11892572;37801334
2021-06-18T09:30:00+02:00;1;Burgenland;2006024;232751;1773273
2021-06-18T09:30:00+02:00;2;Kärnten;1977261;315169;1662092
2021-06-18T09:30:00+02:00;3;Niederösterreich;10116833;1951470;8165363
2021-06-18T09:30:00+02:00;4;Oberösterreich;7595397;745500;6849897
2021-06-18T09:30:00+02:00;5;Salzburg;2913134;404058;2509076
2021-06-18T09:30:00+02:00;6;Steiermark;6469877;761185;5708692
2021-06-18T09:30:00+02:00;7;Tirol;4772236;979629;3792607
2021-06-18T09:30:00+02:00;8;Vorarlberg;2865649;264068;2601581
2021-06-18T09:30:00+02:00;9;Wien;11467186;6316206;5150980
2021-06-18T09:30:00+02:00;10;Österreich;50183597;11970036;38213561
2021-06-19T09:30:00+02:00;1;Burgenland;2026391;232923;1793468
2021-06-19T09:30:00+02:00;2;Kärnten;1977462;315370;1662092
2021-06-19T09:30:00+02:00;3;Niederösterreich;10222213;1955315;8266898
2021-06-19T09:30:00+02:00;4;Oberösterreich;7687434;746058;6941376
2021-06-19T09:30:00+02:00;5;Salzburg;2950878;404397;2546481
2021-06-19T09:30:00+02:00;6;Steiermark;6555795;764261;5791534
2021-06-19T09:30:00+02:00;7;Tirol;4783428;981678;3801750
2021-06-19T09:30:00+02:00;8;Vorarlberg;2879780;264316;2615464
2021-06-19T09:30:00+02:00;9;Wien;11580548;6387685;5192863
2021-06-19T09:30:00+02:00;10;Österreich;50663929;12052003;38611926
2021-06-20T09:30:00+02:00;1;Burgenland;2039220;232946;1806274
2021-06-20T09:30:00+02:00;2;Kärnten;1977544;315452;1662092
2021-06-20T09:30:00+02:00;3;Niederösterreich;10320165;1958547;8361618
2021-06-20T09:30:00+02:00;4;Oberösterreich;7776776;746432;7030344
2021-06-20T09:30:00+02:00;5;Salzburg;2988333;404516;2583817
2021-06-20T09:30:00+02:00;6;Steiermark;6634725;764562;5870163
2021-06-20T09:30:00+02:00;7;Tirol;4792662;983031;3809631
2021-06-20T09:30:00+02:00;8;Vorarlberg;2886022;264584;2621438
2021-06-20T09:30:00+02:00;9;Wien;11667419;6431378;5236041
2021-06-20T09:30:00+02:00;10;Österreich;51082866;12101448;38981418
2021-06-21T09:30:00+02:00;1;Burgenland;2052395;233118;1819277
2021-06-21T09:30:00+02:00;2;Kärnten;1977658;315566;1662092
2021-06-21T09:30:00+02:00;3;Niederösterreich;10414049;1961692;8452357
2021-06-21T09:30:00+02:00;4;Oberösterreich;7863422;746865;7116557
2021-06-21T09:30:00+02:00;5;Salzburg;3019003;404691;2614312
2021-06-21T09:30:00+02:00;6;Steiermark;6702817;765124;5937693
2021-06-21T09:30:00+02:00;7;Tirol;4801848;984069;3817779
2021-06-21T09:30:00+02:00;8;Vorarlberg;2889717;264672;2625045
2021-06-21T09:30:00+02:00;9;Wien;11736974;6457420;5279554
2021-06-21T09:30:00+02:00;10;Österreich;51457883;12133217;39324666
2021-06-22T09:30:00+02:00;1;Burgenland;2063940;233253;1830687
2021-06-22T09:30:00+02:00;2;Kärnten;1978219;316127;1662092
2021-06-22T09:30:00+02:00;3;Niederösterreich;10484220;1964792;8519428
2021-06-22T09:30:00+02:00;4;Oberösterreich;7920724;747531;7173193
2021-06-22T09:30:00+02:00;5;Salzburg;3052367;405570;2646797
2021-06-22T09:30:00+02:00;6;Steiermark;6766613;766533;6000080
2021-06-22T09:30:00+02:00;7;Tirol;4809465;985873;3823592
2021-06-22T09:30:00+02:00;8;Vorarlberg;3288639;264811;3023828
2021-06-22T09:30:00+02:00;9;Wien;11799322;6486935;5312387
2021-06-22T09:30:00+02:00;10;Österreich;52163509;12171425;39992084
2021-06-23T09:30:00+02:00;1;Burgenland;2073449;233388;1840061
2021-06-23T09:30:00+02:00;2;Kärnten;1981055;318159;1662896
2021-06-23T09:30:00+02:00;3;Niederösterreich;10553682;1967399;8586283
2021-06-23T09:30:00+02:00;4;Oberösterreich;7973461;748197;7225264
2021-06-23T09:30:00+02:00;5;Salzburg;3074226;406536;2667690
2021-06-23T09:30:00+02:00;6;Steiermark;6853661;767167;6086494
2021-06-23T09:30:00+02:00;7;Tirol;4815067;986689;3828378
2021-06-23T09:30:00+02:00;8;Vorarlberg;3302104;264984;3037120
2021-06-23T09:30:00+02:00;9;Wien;11926667;6586585;5340082
2021-06-23T09:30:00+02:00;10;Österreich;52553372;12279104;40274268
2021-06-24T09:30:00+02:00;1;Burgenland;2083776;233527;1850249
2021-06-24T09:30:00+02:00;2;Kärnten;1981250;318354;1662896
2021-06-24T09:30:00+02:00;3;Niederösterreich;10621263;1971371;8649892
2021-06-24T09:30:00+02:00;4;Oberösterreich;7994979;748796;7246183
2021-06-24T09:30:00+02:00;5;Salzburg;3097940;407443;2690497
2021-06-24T09:30:00+02:00;6;Steiermark;6909925;767963;6141962
2021-06-24T09:30:00+02:00;7;Tirol;4821648;987556;3834092
2021-06-24T09:30:00+02:00;8;Vorarlberg;3317855;265055;3052800
2021-06-24T09:30:00+02:00;9;Wien;12015642;6647475;5368167
2021-06-24T09:30:00+02:00;10;Österreich;52844278;12347540;40496738
2021-06-25T09:30:00+02:00;1;Burgenland;2093723;233848;1859875
2021-06-25T09:30:00+02:00;2;Kärnten;1981348;318452;1662896
2021-06-25T09:30:00+02:00;3;Niederösterreich;10690025;1974866;8715159
2021-06-25T09:30:00+02:00;4;Oberösterreich;8082568;749485;7333083
2021-06-25T09:30:00+02:00;5;Salzburg;3120176;408367;2711809
2021-06-25T09:30:00+02:00;6;Steiermark;6962076;768623;6193453
2021-06-25T09:30:00+02:00;7;Tirol;4928619;988424;3940195
2021-06-25T09:30:00+02:00;8;Vorarlberg;3331638;265149;3066489
2021-06-25T09:30:00+02:00;9;Wien;12105765;6710845;5394920
2021-06-25T09:30:00+02:00;10;Österreich;53295938;12418059;40877879
2021-06-26T09:30:00+02:00;1;Burgenland;2103171;233956;1869215
2021-06-26T09:30:00+02:00;2;Kärnten;2004568;318544;1686024
2021-06-26T09:30:00+02:00;3;Niederösterreich;10774070;1978427;8795643
2021-06-26T09:30:00+02:00;4;Oberösterreich;8155591;750027;7405564
2021-06-26T09:30:00+02:00;5;Salzburg;3150244;408578;2741666
2021-06-26T09:30:00+02:00;6;Steiermark;7035376;769039;6266337
2021-06-26T09:30:00+02:00;7;Tirol;4937564;989483;3948081
2021-06-26T09:30:00+02:00;8;Vorarlberg;3353242;265217;3088025
2021-06-26T09:30:00+02:00;9;Wien;12199720;6771588;5428132
2021-06-26T09:30:00+02:00;10;Österreich;53713546;12484859;41228687
2021-06-27T09:30:00+02:00;1;Burgenland;2122735;234154;1888581
2021-06-27T09:30:00+02:00;2;Kärnten;2004600;318576;1686024
2021-06-27T09:30:00+02:00;3;Niederösterreich;10860588;1981489;8879099
2021-06-27T09:30:00+02:00;4;Oberösterreich;8230399;750238;7480161
2021-06-27T09:30:00+02:00;5;Salzburg;3182300;408698;2773602
2021-06-27T09:30:00+02:00;6;Steiermark;7108156;769214;6338942
2021-06-27T09:30:00+02:00;7;Tirol;4945351;989855;3955496
2021-06-27T09:30:00+02:00;8;Vorarlberg;3372599;265298;3107301
2021-06-27T09:30:00+02:00;9;Wien;12199720;6771588;5428132
2021-06-27T09:30:00+02:00;10;Österreich;54026448;12489110;41537338
2021-06-28T09:30:00+02:00;1;Burgenland;2133953;234649;1899304
2021-06-28T09:30:00+02:00;2;Kärnten;2004662;318638;1686024
2021-06-28T09:30:00+02:00;3;Niederösterreich;10946930;1984462;8962468
2021-06-28T09:30:00+02:00;4;Oberösterreich;8309730;750742;7558988
2021-06-28T09:30:00+02:00;5;Salzburg;3210537;408888;2801649
2021-06-28T09:30:00+02:00;6;Steiermark;7168756;770261;6398495
2021-06-28T09:30:00+02:00;7;Tirol;4953109;990375;3962734
2021-06-28T09:30:00+02:00;8;Vorarlberg;3391186;265355;3125831
2021-06-28T09:30:00+02:00;9;Wien;12335199;6836966;5498233
2021-06-28T09:30:00+02:00;10;Österreich;54454062;12560336;41893726
2021-06-29T09:30:00+02:00;1;Burgenland;2146251;234885;1911366
2021-06-29T09:30:00+02:00;2;Kärnten;2004843;318819;1686024
2021-06-29T09:30:00+02:00;3;Niederösterreich;11017403;1987333;9030070
2021-06-29T09:30:00+02:00;4;Oberösterreich;8364849;751415;7613434
2021-06-29T09:30:00+02:00;5;Salzburg;3243318;409725;2833593
2021-06-29T09:30:00+02:00;6;Steiermark;7229806;770916;6458890
2021-06-29T09:30:00+02:00;7;Tirol;4959296;991365;3967931
2021-06-29T09:30:00+02:00;8;Vorarlberg;3409273;265488;3143785
2021-06-29T09:30:00+02:00;9;Wien;12429991;6901709;5528282
2021-06-29T09:30:00+02:00;10;Österreich;54805030;12631655;42173375
2021-06-30T09:30:00+02:00;1;Burgenland;2155121;235023;1920098
2021-06-30T09:30:00+02:00;2;Kärnten;2005306;319282;1686024
2021-06-30T09:30:00+02:00;3;Niederösterreich;11067509;1989629;9077880
2021-06-30T09:30:00+02:00;4;Oberösterreich;8409696;752165;7657531
2021-06-30T09:30:00+02:00;5;Salzburg;3262409;410585;2851824
2021-06-30T09:30:00+02:00;6;Steiermark;7293891;771642;6522249
2021-06-30T09:30:00+02:00;7;Tirol;4964111;992145;3971966
2021-06-30T09:30:00+02:00;8;Vorarlberg;3421341;265664;3155677
2021-06-30T09:30:00+02:00;9;Wien;12516893;6958825;5558068
2021-06-30T09:30:00+02:00;10;Österreich;55096277;12694960;42401317
2021-07-01T09:30:00+02:00;1;Burgenland;2160674;235316;1925358
2021-07-01T09:30:00+02:00;2;Kärnten;2005566;319542;1686024
2021-07-01T09:30:00+02:00;3;Niederösterreich;11138987;1993143;9145844
2021-07-01T09:30:00+02:00;4;Oberösterreich;8464089;752616;7711473
2021-07-01T09:30:00+02:00;5;Salzburg;3283950;411461;2872489
2021-07-01T09:30:00+02:00;6;Steiermark;7342067;772364;6569703
2021-07-01T09:30:00+02:00;7;Tirol;5066736;992840;4073896
2021-07-01T09:30:00+02:00;8;Vorarlberg;3435819;265755;3170064
2021-07-01T09:30:00+02:00;9;Wien;12601512;7014556;5586956
2021-07-01T09:30:00+02:00;10;Österreich;55499400;12757593;42741807
2021-07-02T09:30:00+02:00;1;Burgenland;2166515;235628;1930887
2021-07-02T09:30:00+02:00;2;Kärnten;2005704;319680;1686024
2021-07-02T09:30:00+02:00;3;Niederösterreich;11200979;1996284;9204695
2021-07-02T09:30:00+02:00;4;Oberösterreich;8515835;753295;7762540
2021-07-02T09:30:00+02:00;5;Salzburg;3306333;412353;2893980
2021-07-02T09:30:00+02:00;6;Steiermark;7389459;772916;6616543
2021-07-02T09:30:00+02:00;7;Tirol;5073133;993638;4079495
2021-07-02T09:30:00+02:00;8;Vorarlberg;3449291;265857;3183434
2021-07-02T09:30:00+02:00;9;Wien;12698933;7084058;5614875
2021-07-02T09:30:00+02:00;10;Österreich;55806182;12833709;42972473
2021-07-03T09:30:00+02:00;1;Burgenland;2192030;235866;1956164
2021-07-03T09:30:00+02:00;2;Kärnten;2005838;319814;1686024
2021-07-03T09:30:00+02:00;3;Niederösterreich;11272519;1999971;9272548
2021-07-03T09:30:00+02:00;4;Oberösterreich;8592464;753643;7838821
2021-07-03T09:30:00+02:00;5;Salzburg;3335947;412552;2923395
2021-07-03T09:30:00+02:00;6;Steiermark;7464225;773219;6691006
2021-07-03T09:30:00+02:00;7;Tirol;5083147;994120;4089027
2021-07-03T09:30:00+02:00;8;Vorarlberg;3470674;265944;3204730
2021-07-03T09:30:00+02:00;9;Wien;12808039;7161043;5646996
2021-07-03T09:30:00+02:00;10;Österreich;56224883;12916172;43308711
2021-07-04T09:30:00+02:00;1;Burgenland;2203993;236305;1967688
2021-07-04T09:30:00+02:00;2;Kärnten;2005860;319836;1686024
2021-07-04T09:30:00+02:00;3;Niederösterreich;11351880;2002541;9349339
2021-07-04T09:30:00+02:00;4;Oberösterreich;8677150;753973;7923177
2021-07-04T09:30:00+02:00;5;Salzburg;3369518;412641;2956877
2021-07-04T09:30:00+02:00;6;Steiermark;7538743;773354;6765389
2021-07-04T09:30:00+02:00;7;Tirol;5091156;994389;4096767
2021-07-04T09:30:00+02:00;8;Vorarlberg;3489689;266018;3223671
2021-07-04T09:30:00+02:00;9;Wien;12887825;7209068;5678757
2021-07-04T09:30:00+02:00;10;Österreich;56615814;12968125;43647689
2021-07-05T09:30:00+02:00;1;Burgenland;2216063;236423;1979640
2021-07-05T09:30:00+02:00;2;Kärnten;2005946;319922;1686024
2021-07-05T09:30:00+02:00;3;Niederösterreich;11425791;2005202;9420589
2021-07-05T09:30:00+02:00;4;Oberösterreich;8748457;754298;7994159
2021-07-05T09:30:00+02:00;5;Salzburg;3393921;412799;2981122
2021-07-05T09:30:00+02:00;6;Steiermark;7588389;773842;6814547
2021-07-05T09:30:00+02:00;7;Tirol;5098875;994733;4104142
2021-07-05T09:30:00+02:00;8;Vorarlberg;3503656;266059;3237597
2021-07-05T09:30:00+02:00;9;Wien;12956818;7245493;5711325
2021-07-05T09:30:00+02:00;10;Österreich;56937916;13008771;43929145
2021-07-06T09:30:00+02:00;1;Burgenland;2227078;236668;1990410
2021-07-06T09:30:00+02:00;2;Kärnten;2026456;320152;1706304
2021-07-06T09:30:00+02:00;3;Niederösterreich;11497689;2007836;9489853
2021-07-06T09:30:00+02:00;4;Oberösterreich;8804234;754778;8049456
2021-07-06T09:30:00+02:00;5;Salzburg;3423985;413394;3010591
2021-07-06T09:30:00+02:00;6;Steiermark;7642510;774070;6868440
2021-07-06T09:30:00+02:00;7;Tirol;5105827;995267;4110560
2021-07-06T09:30:00+02:00;8;Vorarlberg;3518471;266124;3252347
2021-07-06T09:30:00+02:00;9;Wien;13039047;7303311;5735736
2021-07-06T09:30:00+02:00;10;Österreich;57285297;13071600;44213697
2021-07-07T09:30:00+02:00;1;Burgenland;2239293;236920;2002373
2021-07-07T09:30:00+02:00;2;Kärnten;2027343;320348;1706995
2021-07-07T09:30:00+02:00;3;Niederösterreich;11568680;2010400;9558280
2021-07-07T09:30:00+02:00;4;Oberösterreich;8864096;755387;8108709
2021-07-07T09:30:00+02:00;5;Salzburg;3448373;414222;3034151
2021-07-07T09:30:00+02:00;6;Steiermark;7707500;775864;6931636
2021-07-07T09:30:00+02:00;7;Tirol;5111796;995934;4115862
2021-07-07T09:30:00+02:00;8;Vorarlberg;3532307;266210;3266097
2021-07-07T09:30:00+02:00;9;Wien;13121897;7362422;5759475
2021-07-07T09:30:00+02:00;10;Österreich;57621285;13137707;44483578
2021-07-08T09:30:00+02:00;1;Burgenland;2249689;237135;2012554
2021-07-08T09:30:00+02:00;2;Kärnten;2027526;320531;1706995
2021-07-08T09:30:00+02:00;3;Niederösterreich;11635393;2013841;9621552
2021-07-08T09:30:00+02:00;4;Oberösterreich;8920037;755919;8164118
2021-07-08T09:30:00+02:00;5;Salzburg;3472626;414955;3057671
2021-07-08T09:30:00+02:00;6;Steiermark;7760470;776493;6983977
2021-07-08T09:30:00+02:00;7;Tirol;5184975;996493;4188482
2021-07-08T09:30:00+02:00;8;Vorarlberg;3547051;266266;3280785
2021-07-08T09:30:00+02:00;9;Wien;13206040;7422786;5783254
2021-07-08T09:30:00+02:00;10;Österreich;58003807;13204419;44799388
2021-07-09T09:30:00+02:00;1;Burgenland;2261862;237387;2024475
2021-07-09T09:30:00+02:00;2;Kärnten;2027616;320621;1706995
2021-07-09T09:30:00+02:00;3;Niederösterreich;11699461;2016826;9682635
2021-07-09T09:30:00+02:00;4;Oberösterreich;8972783;756425;8216358
2021-07-09T09:30:00+02:00;5;Salzburg;3496858;415810;3081048
2021-07-09T09:30:00+02:00;6;Steiermark;7819271;777047;7042224
2021-07-09T09:30:00+02:00;7;Tirol;5192544;997236;4195308
2021-07-09T09:30:00+02:00;8;Vorarlberg;3561206;266362;3294844
2021-07-09T09:30:00+02:00;9;Wien;13286436;7479627;5806809
2021-07-09T09:30:00+02:00;10;Österreich;58318037;13267341;45050696
2021-07-10T09:30:00+02:00;1;Burgenland;2280028;237460;2042568
2021-07-10T09:30:00+02:00;2;Kärnten;2027758;320763;1706995
2021-07-10T09:30:00+02:00;3;Niederösterreich;11774404;2017489;9756915
2021-07-10T09:30:00+02:00;4;Oberösterreich;9053410;757120;8296290
2021-07-10T09:30:00+02:00;5;Salzburg;3530403;416314;3114089
2021-07-10T09:30:00+02:00;6;Steiermark;7898719;777484;7121235
2021-07-10T09:30:00+02:00;7;Tirol;5203048;997909;4205139
2021-07-10T09:30:00+02:00;8;Vorarlberg;3584352;266535;3317817
2021-07-10T09:30:00+02:00;9;Wien;13379811;7546244;5833567
2021-07-10T09:30:00+02:00;10;Österreich;58731933;13337318;45394615
2021-07-11T09:30:00+02:00;1;Burgenland;2294319;237643;2056676
2021-07-11T09:30:00+02:00;2;Kärnten;2027837;320842;1706995
2021-07-11T09:30:00+02:00;3;Niederösterreich;11859932;2020314;9839618
2021-07-11T09:30:00+02:00;4;Oberösterreich;9139090;757423;8381667
2021-07-11T09:30:00+02:00;5;Salzburg;3565844;416430;3149414
2021-07-11T09:30:00+02:00;6;Steiermark;7976126;777627;7198499
2021-07-11T09:30:00+02:00;7;Tirol;5213119;998284;4214835
2021-07-11T09:30:00+02:00;8;Vorarlberg;3605956;266596;3339360
2021-07-11T09:30:00+02:00;9;Wien;13461676;7600119;5861557
2021-07-11T09:30:00+02:00;10;Österreich;59143899;13395278;45748621
2021-07-12T09:30:00+02:00;1;Burgenland;2303797;237779;2066018
2021-07-12T09:30:00+02:00;2;Kärnten;2027934;320939;1706995
2021-07-12T09:30:00+02:00;3;Niederösterreich;11921741;2023332;9898409
2021-07-12T09:30:00+02:00;4;Oberösterreich;9207415;757835;8449580
2021-07-12T09:30:00+02:00;5;Salzburg;3589262;416589;3172673
2021-07-12T09:30:00+02:00;6;Steiermark;8025027;778071;7246956
2021-07-12T09:30:00+02:00;7;Tirol;5221869;998904;4222965
2021-07-12T09:30:00+02:00;8;Vorarlberg;3621793;266636;3355157
2021-07-12T09:30:00+02:00;9;Wien;13501183;7616472;5884711
2021-07-12T09:30:00+02:00;10;Österreich;59420021;13416557;46003464
2021-07-13T09:30:00+02:00;1;Burgenland;2315231;237929;2077302
2021-07-13T09:30:00+02:00;2;Kärnten;2028134;321139;1706995
2021-07-13T09:30:00+02:00;3;Niederösterreich;11983442;2026280;9957162
2021-07-13T09:30:00+02:00;4;Oberösterreich;9268564;758434;8510130
2021-07-13T09:30:00+02:00;5;Salzburg;3631403;417375;3214028
2021-07-13T09:30:00+02:00;6;Steiermark;8091563;779339;7312224
2021-07-13T09:30:00+02:00;7;Tirol;5230166;999697;4230469
2021-07-13T09:30:00+02:00;8;Vorarlberg;3639021;266697;3372324
2021-07-13T09:30:00+02:00;9;Wien;13578972;7670876;5908096
2021-07-13T09:30:00+02:00;10;Österreich;59766496;13477766;46288730
2021-07-14T09:30:00+02:00;1;Burgenland;2325669;238406;2087263
2021-07-14T09:30:00+02:00;2;Kärnten;2028258;321263;1706995
2021-07-14T09:30:00+02:00;3;Niederösterreich;12038291;2028591;10009700
2021-07-14T09:30:00+02:00;4;Oberösterreich;9285055;759078;8525977
2021-07-14T09:30:00+02:00;5;Salzburg;3654719;418233;3236486
2021-07-14T09:30:00+02:00;6;Steiermark;8160815;780031;7380784
2021-07-14T09:30:00+02:00;7;Tirol;5237486;1000687;4236799
2021-07-14T09:30:00+02:00;8;Vorarlberg;3652329;266788;3385541
2021-07-14T09:30:00+02:00;9;Wien;13665654;7736770;5928884
2021-07-14T09:30:00+02:00;10;Österreich;60048276;13549847;46498429
2021-07-15T09:30:00+02:00;1;Burgenland;2335203;238679;2096524
2021-07-15T09:30:00+02:00;2;Kärnten;2412999;321788;2091211
2021-07-15T09:30:00+02:00;3;Niederösterreich;12099340;2031797;10067543
2021-07-15T09:30:00+02:00;4;Oberösterreich;9386949;759649;8627300
2021-07-15T09:30:00+02:00;5;Salzburg;3681659;419082;3262577
2021-07-15T09:30:00+02:00;6;Steiermark;8216717;780724;7435993
2021-07-15T09:30:00+02:00;7;Tirol;5277624;1001563;4276061
2021-07-15T09:30:00+02:00;8;Vorarlberg;3667742;266871;3400871
2021-07-15T09:30:00+02:00;9;Wien;13699486;7755339;5944147
2021-07-15T09:30:00+02:00;10;Österreich;60777719;13575492;47202227
2021-07-16T09:30:00+02:00;1;Burgenland;2345173;238833;2106340
2021-07-16T09:30:00+02:00;2;Kärnten;2413306;322095;2091211
2021-07-16T09:30:00+02:00;3;Niederösterreich;12154232;2034859;10119373
2021-07-16T09:30:00+02:00;4;Oberösterreich;9448210;760236;8687974
2021-07-16T09:30:00+02:00;5;Salzburg;3708698;420085;3288613
2021-07-16T09:30:00+02:00;6;Steiermark;8272861;781603;7491258
2021-07-16T09:30:00+02:00;7;Tirol;5285321;1002424;4282897
2021-07-16T09:30:00+02:00;8;Vorarlberg;3682921;266961;3415960
2021-07-16T09:30:00+02:00;9;Wien;13809541;7843307;5966234
2021-07-16T09:30:00+02:00;10;Österreich;61120263;13670403;47449860
2021-07-17T09:30:00+02:00;1;Burgenland;2362550;238865;2123685
2021-07-17T09:30:00+02:00;2;Kärnten;2413435;322224;2091211
2021-07-17T09:30:00+02:00;3;Niederösterreich;12231758;2037920;10193838
2021-07-17T09:30:00+02:00;4;Oberösterreich;9535248;760937;8774311
2021-07-17T09:30:00+02:00;5;Salzburg;3742475;420576;3321899
2021-07-17T09:30:00+02:00;6;Steiermark;8349779;782031;7567748
2021-07-17T09:30:00+02:00;7;Tirol;5296672;1003518;4293154
2021-07-17T09:30:00+02:00;8;Vorarlberg;3703578;267087;3436491
2021-07-17T09:30:00+02:00;9;Wien;13894039;7904335;5989704
2021-07-17T09:30:00+02:00;10;Österreich;61529534;13737493;47792041
2021-07-18T09:30:00+02:00;1;Burgenland;2374580;239012;2135568
2021-07-18T09:30:00+02:00;2;Kärnten;2413518;322307;2091211
2021-07-18T09:30:00+02:00;3;Niederösterreich;12306195;2040908;10265287
2021-07-18T09:30:00+02:00;4;Oberösterreich;9622001;761338;8860663
2021-07-18T09:30:00+02:00;5;Salzburg;3775832;420935;3354897
2021-07-18T09:30:00+02:00;6;Steiermark;8422590;782535;7640055
2021-07-18T09:30:00+02:00;7;Tirol;5306414;1004294;4302120
2021-07-18T09:30:00+02:00;8;Vorarlberg;3723417;267196;3456221
2021-07-18T09:30:00+02:00;9;Wien;13953387;7942197;6011190
2021-07-18T09:30:00+02:00;10;Österreich;61897934;13780722;48117212
2021-07-19T09:30:00+02:00;1;Burgenland;2386653;239217;2147436
2021-07-19T09:30:00+02:00;2;Kärnten;2413708;322497;2091211
2021-07-19T09:30:00+02:00;3;Niederösterreich;12358842;2043991;10314851
2021-07-19T09:30:00+02:00;4;Oberösterreich;9685060;761991;8923069
2021-07-19T09:30:00+02:00;5;Salzburg;3796349;421279;3375070
2021-07-19T09:30:00+02:00;6;Steiermark;8464030;783299;7680731
2021-07-19T09:30:00+02:00;7;Tirol;5314375;1005022;4309353
2021-07-19T09:30:00+02:00;8;Vorarlberg;3736595;267277;3469318
2021-07-19T09:30:00+02:00;9;Wien;14004832;7971622;6033210
2021-07-19T09:30:00+02:00;10;Österreich;62160444;13816195;48344249
2021-07-20T09:30:00+02:00;1;Burgenland;2396215;239366;2156849
2021-07-20T09:30:00+02:00;2;Kärnten;2543197;322736;2220461
2021-07-20T09:30:00+02:00;3;Niederösterreich;12412216;2047121;10365095
2021-07-20T09:30:00+02:00;4;Oberösterreich;9741255;762746;8978509
2021-07-20T09:30:00+02:00;5;Salzburg;3835737;422454;3413283
2021-07-20T09:30:00+02:00;6;Steiermark;8520301;785246;7735055
2021-07-20T09:30:00+02:00;7;Tirol;5322924;1005963;4316961
2021-07-20T09:30:00+02:00;8;Vorarlberg;3752942;267443;3485499
2021-07-20T09:30:00+02:00;9;Wien;14082118;8030815;6051303
2021-07-20T09:30:00+02:00;10;Österreich;62606905;13883890;48723015
2021-07-21T09:30:00+02:00;1;Burgenland;2405748;239691;2166057
2021-07-21T09:30:00+02:00;2;Kärnten;2546656;323024;2223632
2021-07-21T09:30:00+02:00;3;Niederösterreich;12461872;2049451;10412421
2021-07-21T09:30:00+02:00;4;Oberösterreich;9796808;763542;9033266
2021-07-21T09:30:00+02:00;5;Salzburg;3861348;423395;3437953
2021-07-21T09:30:00+02:00;6;Steiermark;8591433;786181;7805252
2021-07-21T09:30:00+02:00;7;Tirol;5330439;1007018;4323421
2021-07-21T09:30:00+02:00;8;Vorarlberg;3767898;267443;3500455
2021-07-21T09:30:00+02:00;9;Wien;14159277;8093123;6066154
2021-07-21T09:30:00+02:00;10;Österreich;62921479;13952868;48968611
2021-07-22T09:30:00+02:00;1;Burgenland;2414825;239738;2175087
2021-07-22T09:30:00+02:00;2;Kärnten;2547004;323372;2223632
2021-07-22T09:30:00+02:00;3;Niederösterreich;12521663;2053007;10468656
2021-07-22T09:30:00+02:00;4;Oberösterreich;9862860;764184;9098676
2021-07-22T09:30:00+02:00;5;Salzburg;3892072;424560;3467512
2021-07-22T09:30:00+02:00;6;Steiermark;8648183;787097;7861086
2021-07-22T09:30:00+02:00;7;Tirol;5358989;1008007;4350982
2021-07-22T09:30:00+02:00;8;Vorarlberg;3785106;267791;3517315
2021-07-22T09:30:00+02:00;9;Wien;14227187;8145617;6081570
2021-07-22T09:30:00+02:00;10;Österreich;63257889;14013373;49244516
2021-07-23T09:30:00+02:00;1;Burgenland;2424732;240061;2184671
2021-07-23T09:30:00+02:00;2;Kärnten;2547361;323729;2223632
2021-07-23T09:30:00+02:00;3;Niederösterreich;12572713;2056124;10516589
2021-07-23T09:30:00+02:00;4;Oberösterreich;9926548;764946;9161602
2021-07-23T09:30:00+02:00;5;Salzburg;3920707;425123;3495584
2021-07-23T09:30:00+02:00;6;Steiermark;8704450;792284;7912166
2021-07-23T09:30:00+02:00;7;Tirol;5367306;1009676;4357630
2021-07-23T09:30:00+02:00;8;Vorarlberg;3802538;268107;3534431
2021-07-23T09:30:00+02:00;9;Wien;14305095;8207866;6097229
2021-07-23T09:30:00+02:00;10;Österreich;63571450;14087916;49483534
2021-07-24T09:30:00+02:00;1;Burgenland;2438110;240126;2197984
2021-07-24T09:30:00+02:00;2;Kärnten;2547572;323940;2223632
2021-07-24T09:30:00+02:00;3;Niederösterreich;12647340;2059253;10588087
2021-07-24T09:30:00+02:00;4;Oberösterreich;10010539;765655;9244884
2021-07-24T09:30:00+02:00;5;Salzburg;3956618;425366;3531252
2021-07-24T09:30:00+02:00;6;Steiermark;8776396;792618;7983778
2021-07-24T09:30:00+02:00;7;Tirol;5378780;1011688;4367092
2021-07-24T09:30:00+02:00;8;Vorarlberg;3824126;268338;3555788
2021-07-24T09:30:00+02:00;9;Wien;14391665;8276911;6114754
2021-07-24T09:30:00+02:00;10;Österreich;63971146;14163895;49807251
2021-07-25T09:30:00+02:00;1;Burgenland;2448989;240273;2208716
2021-07-25T09:30:00+02:00;2;Kärnten;2547723;324091;2223632
2021-07-25T09:30:00+02:00;3;Niederösterreich;12720721;2062352;10658369
2021-07-25T09:30:00+02:00;4;Oberösterreich;10094478;766225;9328253
2021-07-25T09:30:00+02:00;5;Salzburg;3993181;427064;3566117
2021-07-25T09:30:00+02:00;6;Steiermark;8848634;792881;8055753
2021-07-25T09:30:00+02:00;7;Tirol;5389026;1013502;4375524
2021-07-25T09:30:00+02:00;8;Vorarlberg;3842369;268493;3573876
2021-07-25T09:30:00+02:00;9;Wien;14452112;8319467;6132645
2021-07-25T09:30:00+02:00;10;Österreich;64337233;14214348;50122885
2021-07-26T09:30:00+02:00;1;Burgenland;2457961;240584;2217377
2021-07-26T09:30:00+02:00;2;Kärnten;2547930;324298;2223632
2021-07-26T09:30:00+02:00;3;Niederösterreich;12771312;2069699;10701613
2021-07-26T09:30:00+02:00;4;Oberösterreich;10159709;766900;9392809
2021-07-26T09:30:00+02:00;5;Salzburg;4018368;427453;3590915
2021-07-26T09:30:00+02:00;6;Steiermark;8894333;793660;8100673
2021-07-26T09:30:00+02:00;7;Tirol;5396948;1014880;4382068
2021-07-26T09:30:00+02:00;8;Vorarlberg;3854991;268686;3586305
2021-07-26T09:30:00+02:00;9;Wien;14500388;8348769;6151619
2021-07-26T09:30:00+02:00;10;Österreich;64601940;14254929;50347011
2021-07-27T09:30:00+02:00;1;Burgenland;2467595;240724;2226871
2021-07-27T09:30:00+02:00;2;Kärnten;2597223;324530;2272693
2021-07-27T09:30:00+02:00;3;Niederösterreich;12815697;2072222;10743475
2021-07-27T09:30:00+02:00;4;Oberösterreich;10218447;767517;9450930
2021-07-27T09:30:00+02:00;5;Salzburg;4056730;430467;3626263
2021-07-27T09:30:00+02:00;6;Steiermark;8955580;796133;8159447
2021-07-27T09:30:00+02:00;7;Tirol;5405676;1016184;4389492
2021-07-27T09:30:00+02:00;8;Vorarlberg;3869090;268888;3600202
2021-07-27T09:30:00+02:00;9;Wien;14569778;8403414;6166364
2021-07-27T09:30:00+02:00;10;Österreich;64955816;14320079;50635737
2021-07-28T09:30:00+02:00;1;Burgenland;2480014;240965;2239049
2021-07-28T09:30:00+02:00;2;Kärnten;2737296;324908;2412388
2021-07-28T09:30:00+02:00;3;Niederösterreich;12863500;2075071;10788429
2021-07-28T09:30:00+02:00;4;Oberösterreich;10274309;773644;9500665
2021-07-28T09:30:00+02:00;5;Salzburg;4083847;432502;3651345
2021-07-28T09:30:00+02:00;6;Steiermark;9016091;798187;8217904
2021-07-28T09:30:00+02:00;7;Tirol;5412261;1017705;4394556
2021-07-28T09:30:00+02:00;8;Vorarlberg;3882551;269054;3613497
2021-07-28T09:30:00+02:00;9;Wien;14631891;8453689;6178202
2021-07-28T09:30:00+02:00;10;Österreich;65381760;14385725;50996035
2021-07-29T09:30:00+02:00;1;Burgenland;2489193;241171;2248022
2021-07-29T09:30:00+02:00;2;Kärnten;2739212;325270;2413942
2021-07-29T09:30:00+02:00;3;Niederösterreich;12918881;2078038;10840843
2021-07-29T09:30:00+02:00;4;Oberösterreich;10335971;774968;9561003
2021-07-29T09:30:00+02:00;5;Salzburg;4116569;434516;3682053
2021-07-29T09:30:00+02:00;6;Steiermark;9066752;798803;8267949
2021-07-29T09:30:00+02:00;7;Tirol;5464071;1019261;4444810
2021-07-29T09:30:00+02:00;8;Vorarlberg;3896921;269234;3627687
2021-07-29T09:30:00+02:00;9;Wien;14697491;8507227;6190264
2021-07-29T09:30:00+02:00;10;Österreich;65725061;14448488;51276573
2021-07-30T09:30:00+02:00;1;Burgenland;2498228;241374;2256854
2021-07-30T09:30:00+02:00;2;Kärnten;2882705;325542;2557163
2021-07-30T09:30:00+02:00;3;Niederösterreich;12975494;2081075;10894419
2021-07-30T09:30:00+02:00;4;Oberösterreich;10398995;776586;9622409
2021-07-30T09:30:00+02:00;5;Salzburg;4149240;437214;3712026
2021-07-30T09:30:00+02:00;6;Steiermark;9117514;799207;8318307
2021-07-30T09:30:00+02:00;7;Tirol;5487533;1021560;4465973
2021-07-30T09:30:00+02:00;8;Vorarlberg;3913604;269403;3644201
2021-07-30T09:30:00+02:00;9;Wien;14776429;8573421;6203008
2021-07-30T09:30:00+02:00;10;Österreich;66199742;14525382;51674360
2021-07-31T09:30:00+02:00;1;Burgenland;2514970;241474;2273496
2021-07-31T09:30:00+02:00;2;Kärnten;2895191;325795;2569396
2021-07-31T09:30:00+02:00;3;Niederösterreich;13033212;2084344;10948868
2021-07-31T09:30:00+02:00;4;Oberösterreich;10478249;778884;9699365
2021-07-31T09:30:00+02:00;5;Salzburg;4185256;437214;3748042
2021-07-31T09:30:00+02:00;6;Steiermark;9183605;799753;8383852
2021-07-31T09:30:00+02:00;7;Tirol;5498561;1024131;4474430
2021-07-31T09:30:00+02:00;8;Vorarlberg;3932134;269687;3662447
2021-07-31T09:30:00+02:00;9;Wien;14846127;8628851;6217276
2021-07-31T09:30:00+02:00;10;Österreich;66567305;14590133;51977172
2021-08-01T09:30:00+02:00;1;Burgenland;2525316;241713;2283603
2021-08-01T09:30:00+02:00;2;Kärnten;2902519;326002;2576517
2021-08-01T09:30:00+02:00;3;Niederösterreich;13095992;2087571;11008421
2021-08-01T09:30:00+02:00;4;Oberösterreich;10554777;779348;9775429
2021-08-01T09:30:00+02:00;5;Salzburg;4225881;442509;3783372
2021-08-01T09:30:00+02:00;6;Steiermark;9248191;800224;8447967
2021-08-01T09:30:00+02:00;7;Tirol;5508932;1025646;4483286
2021-08-01T09:30:00+02:00;8;Vorarlberg;3949440;269939;3679501
2021-08-01T09:30:00+02:00;9;Wien;14905695;8674551;6231144
2021-08-01T09:30:00+02:00;10;Österreich;66916743;14647503;52269240
2021-08-02T09:30:00+02:00;1;Burgenland;2532986;241921;2291065
2021-08-02T09:30:00+02:00;2;Kärnten;2902915;326398;2576517
2021-08-02T09:30:00+02:00;3;Niederösterreich;13179751;2090816;11088935
2021-08-02T09:30:00+02:00;4;Oberösterreich;10619481;782316;9837165
2021-08-02T09:30:00+02:00;5;Salzburg;4250646;443598;3807048
2021-08-02T09:30:00+02:00;6;Steiermark;9284259;800657;8483602
2021-08-02T09:30:00+02:00;7;Tirol;5518936;1026954;4491982
2021-08-02T09:30:00+02:00;8;Vorarlberg;3961420;270081;3691339
2021-08-02T09:30:00+02:00;9;Wien;14951518;8704412;6247106
2021-08-02T09:30:00+02:00;10;Österreich;67201912;14687153;52514759
2021-08-03T09:30:00+02:00;1;Burgenland;2543153;242126;2301027
2021-08-03T09:30:00+02:00;2;Kärnten;2907120;326780;2580340
2021-08-03T09:30:00+02:00;3;Niederösterreich;13235495;2093883;11141612
2021-08-03T09:30:00+02:00;4;Oberösterreich;10685155;783243;9901912
2021-08-03T09:30:00+02:00;5;Salzburg;4288787;445259;3843528
2021-08-03T09:30:00+02:00;6;Steiermark;9338471;801324;8537147
2021-08-03T09:30:00+02:00;7;Tirol;5528382;1028205;4500177
2021-08-03T09:30:00+02:00;8;Vorarlberg;3976846;270252;3706594
2021-08-03T09:30:00+02:00;9;Wien;14985021;8725260;6259761
2021-08-03T09:30:00+02:00;10;Österreich;67488430;14716332;52772098
2021-08-04T09:30:00+02:00;1;Burgenland;2550682;242270;2308412
2021-08-04T09:30:00+02:00;2;Kärnten;2908932;327062;2581870
2021-08-04T09:30:00+02:00;3;Niederösterreich;13284346;2097066;11187280
2021-08-04T09:30:00+02:00;4;Oberösterreich;10740863;784913;9955950
2021-08-04T09:30:00+02:00;5;Salzburg;4317832;447376;3870456
2021-08-04T09:30:00+02:00;6;Steiermark;9395109;801870;8593239
2021-08-04T09:30:00+02:00;7;Tirol;5537315;1030089;4507226
2021-08-04T09:30:00+02:00;8;Vorarlberg;3990600;270545;3720055
2021-08-04T09:30:00+02:00;9;Wien;15045879;8774825;6271054
2021-08-04T09:30:00+02:00;10;Österreich;67771558;14776016;52995542
2021-08-05T09:30:00+02:00;1;Burgenland;2558386;242569;2315817
2021-08-05T09:30:00+02:00;2;Kärnten;3046545;327418;2719127
2021-08-05T09:30:00+02:00;3;Niederösterreich;13346139;2100863;11245276
2021-08-05T09:30:00+02:00;4;Oberösterreich;10803193;786451;10016742
2021-08-05T09:30:00+02:00;5;Salzburg;4351539;449624;3901915
2021-08-05T09:30:00+02:00;6;Steiermark;9453147;813511;8639636
2021-08-05T09:30:00+02:00;7;Tirol;5559791;1031508;4528283
2021-08-05T09:30:00+02:00;8;Vorarlberg;4005664;270781;3734883
2021-08-05T09:30:00+02:00;9;Wien;15112334;8829708;6282626
2021-08-05T09:30:00+02:00;10;Österreich;68236738;14852433;53384305
2021-08-06T09:30:00+02:00;1;Burgenland;2566695;242781;2323914
2021-08-06T09:30:00+02:00;2;Kärnten;3046935;327808;2719127
2021-08-06T09:30:00+02:00;3;Niederösterreich;13393116;2104308;11288808
2021-08-06T09:30:00+02:00;4;Oberösterreich;10860034;787772;10072262
2021-08-06T09:30:00+02:00;5;Salzburg;4383628;452698;3930930
2021-08-06T09:30:00+02:00;6;Steiermark;9501102;817289;8683813
2021-08-06T09:30:00+02:00;7;Tirol;5569850;1033647;4536203
2021-08-06T09:30:00+02:00;8;Vorarlberg;4020521;270944;3749577
2021-08-06T09:30:00+02:00;9;Wien;15183652;8889189;6294463
2021-08-06T09:30:00+02:00;10;Österreich;68525533;14926436;53599097
2021-08-07T09:30:00+02:00;1;Burgenland;2577995;242918;2335077
2021-08-07T09:30:00+02:00;2;Kärnten;3059190;329341;2729849
2021-08-07T09:30:00+02:00;3;Niederösterreich;13461545;2107850;11353695
2021-08-07T09:30:00+02:00;4;Oberösterreich;10932246;789874;10142372
2021-08-07T09:30:00+02:00;5;Salzburg;4425367;456613;3968754
2021-08-07T09:30:00+02:00;6;Steiermark;9568400;820685;8747715
2021-08-07T09:30:00+02:00;7;Tirol;5592467;1036887;4555580
2021-08-07T09:30:00+02:00;8;Vorarlberg;4039944;271162;3768782
2021-08-07T09:30:00+02:00;9;Wien;15279536;8971580;6307956
2021-08-07T09:30:00+02:00;10;Österreich;68936690;15026910;53909780
2021-08-08T09:30:00+02:00;1;Burgenland;2588272;243068;2345204
2021-08-08T09:30:00+02:00;2;Kärnten;3059329;329480;2729849
2021-08-08T09:30:00+02:00;3;Niederösterreich;13532624;2111020;11421604
2021-08-08T09:30:00+02:00;4;Oberösterreich;11009949;790465;10219484
2021-08-08T09:30:00+02:00;5;Salzburg;4466674;458900;4007774
2021-08-08T09:30:00+02:00;6;Steiermark;9638965;823434;8815531
2021-08-08T09:30:00+02:00;7;Tirol;5604332;1038329;4566003
2021-08-08T09:30:00+02:00;8;Vorarlberg;4057687;271381;3786306
2021-08-08T09:30:00+02:00;9;Wien;15325371;9007143;6318228
2021-08-08T09:30:00+02:00;10;Österreich;69283203;15073220;54209983
2021-08-09T09:30:00+02:00;1;Burgenland;2596181;243233;2352948
2021-08-09T09:30:00+02:00;2;Kärnten;3059995;329710;2730285
2021-08-09T09:30:00+02:00;3;Niederösterreich;13586145;2113979;11472166
2021-08-09T09:30:00+02:00;4;Oberösterreich;11071913;791205;10280708
2021-08-09T09:30:00+02:00;5;Salzburg;4492570;460177;4032393
2021-08-09T09:30:00+02:00;6;Steiermark;9678241;825746;8852495
2021-08-09T09:30:00+02:00;7;Tirol;5614835;1039568;4575267
2021-08-09T09:30:00+02:00;8;Vorarlberg;4070505;271502;3799003
2021-08-09T09:30:00+02:00;9;Wien;15367560;9032610;6334950
2021-08-09T09:30:00+02:00;10;Österreich;69537945;15107730;54430215
2021-08-10T09:30:00+02:00;1;Burgenland;2614580;249486;2365094
2021-08-10T09:30:00+02:00;2;Kärnten;3061590;330028;2731562
2021-08-10T09:30:00+02:00;3;Niederösterreich;13638914;2117382;11521532
2021-08-10T09:30:00+02:00;4;Oberösterreich;11127656;794543;10333113
2021-08-10T09:30:00+02:00;5;Salzburg;4529397;461390;4068007
2021-08-10T09:30:00+02:00;6;Steiermark;9731220;826412;8904808
2021-08-10T09:30:00+02:00;7;Tirol;5624683;1041240;4583443
2021-08-10T09:30:00+02:00;8;Vorarlberg;4086025;271810;3814215
2021-08-10T09:30:00+02:00;9;Wien;15430120;9083710;6346410
2021-08-10T09:30:00+02:00;10;Österreich;69844185;15176001;54668184
2021-08-11T09:30:00+02:00;1;Burgenland;2622128;249719;2372409
2021-08-11T09:30:00+02:00;2;Kärnten;3063941;331229;2732712
2021-08-11T09:30:00+02:00;3;Niederösterreich;13651107;2120899;11530208
2021-08-11T09:30:00+02:00;4;Oberösterreich;11188620;796294;10392326
2021-08-11T09:30:00+02:00;5;Salzburg;4560633;463981;4096652
2021-08-11T09:30:00+02:00;6;Steiermark;9789618;828609;8961009
2021-08-11T09:30:00+02:00;7;Tirol;5633620;1042840;4590780
2021-08-11T09:30:00+02:00;8;Vorarlberg;4101094;272053;3829041
2021-08-11T09:30:00+02:00;9;Wien;15497838;9141255;6356583
2021-08-11T09:30:00+02:00;10;Österreich;70108599;15246879;54861720
2021-08-12T09:30:00+02:00;1;Burgenland;2630247;250367;2379880
2021-08-12T09:30:00+02:00;2;Kärnten;3207020;330709;2876311
2021-08-12T09:30:00+02:00;3;Niederösterreich;13714222;2125346;11588876
2021-08-12T09:30:00+02:00;4;Oberösterreich;11253459;797131;10456328
2021-08-12T09:30:00+02:00;5;Salzburg;4593615;466067;4127548
2021-08-12T09:30:00+02:00;6;Steiermark;9840551;832242;9008309
2021-08-12T09:30:00+02:00;7;Tirol;5643314;1044408;4598906
2021-08-12T09:30:00+02:00;8;Vorarlberg;4118207;272184;3846023
2021-08-12T09:30:00+02:00;9;Wien;15555771;9188579;6367192
2021-08-12T09:30:00+02:00;10;Österreich;70556406;15307033;55249373
2021-08-13T09:30:00+02:00;1;Burgenland;2638633;250781;2387852
2021-08-13T09:30:00+02:00;2;Kärnten;3207297;330986;2876311
2021-08-13T09:30:00+02:00;3;Niederösterreich;13751787;2128705;11623082
2021-08-13T09:30:00+02:00;4;Oberösterreich;11314138;798941;10515197
2021-08-13T09:30:00+02:00;5;Salzburg;4627285;468759;4158526
2021-08-13T09:30:00+02:00;6;Steiermark;9892971;834266;9058705
2021-08-13T09:30:00+02:00;7;Tirol;5653660;1046529;4607131
2021-08-13T09:30:00+02:00;8;Vorarlberg;4135620;272557;3863063
2021-08-13T09:30:00+02:00;9;Wien;15615562;9237462;6378100
2021-08-13T09:30:00+02:00;10;Österreich;70836953;15368986;55467967
2021-08-14T09:30:00+02:00;1;Burgenland;2651738;251582;2400156
2021-08-14T09:30:00+02:00;2;Kärnten;3217965;331428;2886537
2021-08-14T09:30:00+02:00;3;Niederösterreich;13834722;2132043;11702679
2021-08-14T09:30:00+02:00;4;Oberösterreich;11390158;800816;10589342
2021-08-14T09:30:00+02:00;5;Salzburg;4668324;472374;4195950
2021-08-14T09:30:00+02:00;6;Steiermark;9919930;837728;9082202
2021-08-14T09:30:00+02:00;7;Tirol;5668155;1049813;4618342
2021-08-14T09:30:00+02:00;8;Vorarlberg;4155974;272894;3883080
2021-08-14T09:30:00+02:00;9;Wien;15674778;9284063;6390715
2021-08-14T09:30:00+02:00;10;Österreich;71181744;15432741;55749003
2021-08-15T09:30:00+02:00;1;Burgenland;2660989;251750;2409239
2021-08-15T09:30:00+02:00;2;Kärnten;3218159;331622;2886537
2021-08-15T09:30:00+02:00;3;Niederösterreich;13904982;2135414;11769568
2021-08-15T09:30:00+02:00;4;Oberösterreich;11472878;801618;10671260
2021-08-15T09:30:00+02:00;5;Salzburg;4709322;475306;4234016
2021-08-15T09:30:00+02:00;6;Steiermark;10022024;838434;9183590
2021-08-15T09:30:00+02:00;7;Tirol;5679969;1051270;4628699
2021-08-15T09:30:00+02:00;8;Vorarlberg;4176627;273102;3903525
2021-08-15T09:30:00+02:00;9;Wien;15732499;9327795;6404704
2021-08-15T09:30:00+02:00;10;Österreich;71577449;15486311;56091138
2021-08-16T09:30:00+02:00;1;Burgenland;2667981;251798;2416183
2021-08-16T09:30:00+02:00;2;Kärnten;3219312;331838;2887474
2021-08-16T09:30:00+02:00;3;Niederösterreich;13967558;2138492;11829066
2021-08-16T09:30:00+02:00;4;Oberösterreich;11546843;802502;10744341
2021-08-16T09:30:00+02:00;5;Salzburg;4738848;476897;4261951
2021-08-16T09:30:00+02:00;6;Steiermark;10065896;839335;9226561
2021-08-16T09:30:00+02:00;7;Tirol;5689506;1052588;4636918
2021-08-16T09:30:00+02:00;8;Vorarlberg;4193271;273310;3919961
2021-08-16T09:30:00+02:00;9;Wien;15778635;9357363;6421272
2021-08-16T09:30:00+02:00;10;Österreich;71867850;15524123;56343727
2021-08-17T09:30:00+02:00;1;Burgenland;2676535;251981;2424554
2021-08-17T09:30:00+02:00;2;Kärnten;3223416;333567;2889849
2021-08-17T09:30:00+02:00;3;Niederösterreich;14017921;2143840;11874081
2021-08-17T09:30:00+02:00;4;Oberösterreich;11595901;806329;10789572
2021-08-17T09:30:00+02:00;5;Salzburg;4775135;477947;4297188
2021-08-17T09:30:00+02:00;6;Steiermark;10120285;842529;9277756
2021-08-17T09:30:00+02:00;7;Tirol;5699270;1054546;4644724
2021-08-17T09:30:00+02:00;8;Vorarlberg;4206607;273679;3932928
2021-08-17T09:30:00+02:00;9;Wien;15840185;9407163;6433022
2021-08-17T09:30:00+02:00;10;Österreich;72155255;15591581;56563674
2021-08-18T09:30:00+02:00;1;Burgenland;2682806;252170;2430636
2021-08-18T09:30:00+02:00;2;Kärnten;3225966;333954;2892012
2021-08-18T09:30:00+02:00;3;Niederösterreich;14065720;2147118;11918602
2021-08-18T09:30:00+02:00;4;Oberösterreich;11651463;807942;10843521
2021-08-18T09:30:00+02:00;5;Salzburg;4805291;481082;4324209
2021-08-18T09:30:00+02:00;6;Steiermark;10150988;846800;9304188
2021-08-18T09:30:00+02:00;7;Tirol;5719893;1056337;4663556
2021-08-18T09:30:00+02:00;8;Vorarlberg;4219886;274051;3945835
2021-08-18T09:30:00+02:00;9;Wien;15902874;9460930;6441944
2021-08-18T09:30:00+02:00;10;Österreich;72424887;15660384;56764503
2021-08-19T09:30:00+02:00;1;Burgenland;2691302;253594;2437708
2021-08-19T09:30:00+02:00;2;Kärnten;3378769;334201;3044568
2021-08-19T09:30:00+02:00;3;Niederösterreich;14113145;2150790;11962355
2021-08-19T09:30:00+02:00;4;Oberösterreich;11703674;809802;10893872
2021-08-19T09:30:00+02:00;5;Salzburg;4835629;483640;4351989
2021-08-19T09:30:00+02:00;6;Steiermark;10218867;849101;9369766
2021-08-19T09:30:00+02:00;7;Tirol;5729581;1058188;4671393
2021-08-19T09:30:00+02:00;8;Vorarlberg;4234426;274419;3960007
2021-08-19T09:30:00+02:00;9;Wien;15962352;9511109;6451243
2021-08-19T09:30:00+02:00;10;Österreich;72867745;15724844;57142901
2021-08-20T09:30:00+02:00;1;Burgenland;2698360;254028;2444332
2021-08-20T09:30:00+02:00;2;Kärnten;3379163;334595;3044568
2021-08-20T09:30:00+02:00;3;Niederösterreich;14165204;2153997;12011207
2021-08-20T09:30:00+02:00;4;Oberösterreich;11763943;811794;10952149
2021-08-20T09:30:00+02:00;5;Salzburg;4865916;486038;4379878
2021-08-20T09:30:00+02:00;6;Steiermark;10266082;854801;9411281
2021-08-20T09:30:00+02:00;7;Tirol;5739151;1060703;4678448
2021-08-20T09:30:00+02:00;8;Vorarlberg;4249482;274819;3974663
2021-08-20T09:30:00+02:00;9;Wien;16009055;9548612;6460443
2021-08-20T09:30:00+02:00;10;Österreich;73136356;15779387;57356969
2021-08-21T09:30:00+02:00;1;Burgenland;2708133;254544;2453589
2021-08-21T09:30:00+02:00;2;Kärnten;3389743;336105;3053638
2021-08-21T09:30:00+02:00;3;Niederösterreich;14229083;2157296;12071787
2021-08-21T09:30:00+02:00;4;Oberösterreich;11836158;814346;11021812
2021-08-21T09:30:00+02:00;5;Salzburg;4905441;490341;4415100
2021-08-21T09:30:00+02:00;6;Steiermark;10322177;858721;9463456
2021-08-21T09:30:00+02:00;7;Tirol;5751320;1063064;4688256
2021-08-21T09:30:00+02:00;8;Vorarlberg;4267729;274819;3992910
2021-08-21T09:30:00+02:00;9;Wien;16092764;9622012;6470752
2021-08-21T09:30:00+02:00;10;Österreich;73502548;15871248;57631300
2021-08-22T09:30:00+02:00;1;Burgenland;2717628;255519;2462109
2021-08-22T09:30:00+02:00;2;Kärnten;3389994;336356;3053638
2021-08-22T09:30:00+02:00;3;Niederösterreich;14300736;2160989;12139747
2021-08-22T09:30:00+02:00;4;Oberösterreich;11915126;815038;11100088
2021-08-22T09:30:00+02:00;5;Salzburg;4943735;492689;4451046
2021-08-22T09:30:00+02:00;6;Steiermark;10392712;862131;9530581
2021-08-22T09:30:00+02:00;7;Tirol;5762047;1064884;4697163
2021-08-22T09:30:00+02:00;8;Vorarlberg;4286911;275605;4011306
2021-08-22T09:30:00+02:00;9;Wien;16123745;9642059;6481686
2021-08-22T09:30:00+02:00;10;Österreich;73832634;15905270;57927364
2021-08-23T09:30:00+02:00;1;Burgenland;2725221;256165;2469056
2021-08-23T09:30:00+02:00;2;Kärnten;3390884;336648;3054236
2021-08-23T09:30:00+02:00;3;Niederösterreich;14356398;2164121;12192277
2021-08-23T09:30:00+02:00;4;Oberösterreich;11977725;816026;11161699
2021-08-23T09:30:00+02:00;5;Salzburg;4967645;494187;4473458
2021-08-23T09:30:00+02:00;6;Steiermark;10435287;864432;9570855
2021-08-23T09:30:00+02:00;7;Tirol;5770965;1066257;4704708
2021-08-23T09:30:00+02:00;8;Vorarlberg;4297871;275938;4021933
2021-08-23T09:30:00+02:00;9;Wien;16194692;9699373;6495319
2021-08-23T09:30:00+02:00;10;Österreich;74116688;15973147;58143541
2021-08-24T09:30:00+02:00;1;Burgenland;2732941;256812;2476129
2021-08-24T09:30:00+02:00;2;Kärnten;3396393;336959;3059434
2021-08-24T09:30:00+02:00;3;Niederösterreich;14404229;2167317;12236912
2021-08-24T09:30:00+02:00;4;Oberösterreich;12026117;820304;11205813
2021-08-24T09:30:00+02:00;5;Salzburg;5007198;495771;4511427
2021-08-24T09:30:00+02:00;6;Steiermark;10485451;868006;9617445
2021-08-24T09:30:00+02:00;7;Tirol;5779559;1068110;4711449
2021-08-24T09:30:00+02:00;8;Vorarlberg;4311342;276344;4034998
2021-08-24T09:30:00+02:00;9;Wien;16251445;9745848;6505597
2021-08-24T09:30:00+02:00;10;Österreich;74394675;16035471;58359204
2021-08-25T09:30:00+02:00;1;Burgenland;2739606;257198;2482408
2021-08-25T09:30:00+02:00;2;Kärnten;3397100;337517;3059583
2021-08-25T09:30:00+02:00;3;Niederösterreich;14445035;2170907;12274128
2021-08-25T09:30:00+02:00;4;Oberösterreich;12079011;822287;11256724
2021-08-25T09:30:00+02:00;5;Salzburg;5033576;498550;4535026
2021-08-25T09:30:00+02:00;6;Steiermark;10538602;870756;9667846
2021-08-25T09:30:00+02:00;7;Tirol;5799365;1069988;4729377
2021-08-25T09:30:00+02:00;8;Vorarlberg;4324131;276797;4047334
2021-08-25T09:30:00+02:00;9;Wien;16319694;9806122;6513572
2021-08-25T09:30:00+02:00;10;Österreich;74676120;16110122;58565998
2021-08-26T09:30:00+02:00;1;Burgenland;2747484;258583;2488901
2021-08-26T09:30:00+02:00;2;Kärnten;3540847;338153;3202694
2021-08-26T09:30:00+02:00;3;Niederösterreich;14499652;2175548;12324104
2021-08-26T09:30:00+02:00;4;Oberösterreich;12138214;824221;11313993
2021-08-26T09:30:00+02:00;5;Salzburg;5063528;501422;4562106
2021-08-26T09:30:00+02:00;6;Steiermark;10579866;872645;9707221
2021-08-26T09:30:00+02:00;7;Tirol;5807109;1071586;4735523
2021-08-26T09:30:00+02:00;8;Vorarlberg;4338518;277079;4061439
2021-08-26T09:30:00+02:00;9;Wien;16383636;9861724;6521912
2021-08-26T09:30:00+02:00;10;Österreich;75098854;16180961;58917893
2021-08-27T09:30:00+02:00;1;Burgenland;2753733;258741;2494992
2021-08-27T09:30:00+02:00;2;Kärnten;3541283;338589;3202694
2021-08-27T09:30:00+02:00;3;Niederösterreich;14548224;2179571;12368653
2021-08-27T09:30:00+02:00;4;Oberösterreich;12188246;826471;11361775
2021-08-27T09:30:00+02:00;5;Salzburg;5091560;504698;4586862
2021-08-27T09:30:00+02:00;6;Steiermark;10621052;875116;9745936
2021-08-27T09:30:00+02:00;7;Tirol;5815012;1073533;4741479
2021-08-27T09:30:00+02:00;8;Vorarlberg;4351614;277504;4074110
2021-08-27T09:30:00+02:00;9;Wien;16443577;9913881;6529696
2021-08-27T09:30:00+02:00;10;Österreich;75354301;16248104;59106197
2021-08-28T09:30:00+02:00;1;Burgenland;2767135;259888;2507247
2021-08-28T09:30:00+02:00;2;Kärnten;3550900;340172;3210728
2021-08-28T09:30:00+02:00;3;Niederösterreich;14590193;2182998;12407195
2021-08-28T09:30:00+02:00;4;Oberösterreich;12256025;829223;11426802
2021-08-28T09:30:00+02:00;5;Salzburg;5127916;509476;4618440
2021-08-28T09:30:00+02:00;6;Steiermark;10680986;881220;9799766
2021-08-28T09:30:00+02:00;7;Tirol;5826704;1076411;4750293
2021-08-28T09:30:00+02:00;8;Vorarlberg;4368825;277967;4090858
2021-08-28T09:30:00+02:00;9;Wien;16512041;9973082;6538959
2021-08-28T09:30:00+02:00;10;Österreich;75680725;16330437;59350288
2021-08-29T09:30:00+02:00;1;Burgenland;2776125;261407;2514718
2021-08-29T09:30:00+02:00;2;Kärnten;3551153;340425;3210728
2021-08-29T09:30:00+02:00;3;Niederösterreich;14676731;2186330;12490401
2021-08-29T09:30:00+02:00;4;Oberösterreich;12329559;830363;11499196
2021-08-29T09:30:00+02:00;5;Salzburg;5161226;512543;4648683
2021-08-29T09:30:00+02:00;6;Steiermark;10736277;884768;9851509
2021-08-29T09:30:00+02:00;7;Tirol;5836199;1078478;4757721
2021-08-29T09:30:00+02:00;8;Vorarlberg;4384792;278265;4106527
2021-08-29T09:30:00+02:00;9;Wien;16560946;10011858;6549088
2021-08-29T09:30:00+02:00;10;Österreich;76013008;16384437;59628571
2021-08-30T09:30:00+02:00;1;Burgenland;2782931;262191;2520740
2021-08-30T09:30:00+02:00;2;Kärnten;3551767;340728;3211039
2021-08-30T09:30:00+02:00;3;Niederösterreich;14729499;2189388;12540111
2021-08-30T09:30:00+02:00;4;Oberösterreich;12388346;831486;11556860
2021-08-30T09:30:00+02:00;5;Salzburg;5182671;513953;4668718
2021-08-30T09:30:00+02:00;6;Steiermark;10771540;887221;9884319
2021-08-30T09:30:00+02:00;7;Tirol;5843541;1079800;4763741
2021-08-30T09:30:00+02:00;8;Vorarlberg;4395094;278633;4116461
2021-08-30T09:30:00+02:00;9;Wien;16598253;10037173;6561080
2021-08-30T09:30:00+02:00;10;Österreich;76243642;16420573;59823069
2021-08-31T09:30:00+02:00;1;Burgenland;2791257;262780;2528477
2021-08-31T09:30:00+02:00;2;Kärnten;3555562;341027;3214535
2021-08-31T09:30:00+02:00;3;Niederösterreich;14777235;2192341;12584894
2021-08-31T09:30:00+02:00;4;Oberösterreich;12437817;836309;11601508
2021-08-31T09:30:00+02:00;5;Salzburg;5219203;515770;4703433
2021-08-31T09:30:00+02:00;6;Steiermark;10816555;888150;9928405
2021-08-31T09:30:00+02:00;7;Tirol;5850693;1081410;4769283
2021-08-31T09:30:00+02:00;8;Vorarlberg;4407614;278973;4128641
2021-08-31T09:30:00+02:00;9;Wien;16662168;10089268;6572900
2021-08-31T09:30:00+02:00;10;Österreich;76518104;16486028;60032076
2021-09-01T09:30:00+02:00;1;Burgenland;2797907;263853;2534054
2021-09-01T09:30:00+02:00;2;Kärnten;3557341;341634;3215707
2021-09-01T09:30:00+02:00;3;Niederösterreich;14818665;2195629;12623036
2021-09-01T09:30:00+02:00;4;Oberösterreich;12490663;838414;11652249
2021-09-01T09:30:00+02:00;5;Salzburg;5240788;517639;4723149
2021-09-01T09:30:00+02:00;6;Steiermark;10867138;890514;9976624
2021-09-01T09:30:00+02:00;7;Tirol;5868409;1083315;4785094
2021-09-01T09:30:00+02:00;8;Vorarlberg;4419510;279489;4140021
2021-09-01T09:30:00+02:00;9;Wien;16740110;10157566;6582544
2021-09-01T09:30:00+02:00;10;Österreich;76800531;16568053;60232478
2021-09-02T09:30:00+02:00;1;Burgenland;2805262;265042;2540220
2021-09-02T09:30:00+02:00;2;Kärnten;3686589;342236;3344353
2021-09-02T09:30:00+02:00;3;Niederösterreich;14872582;2200011;12672571
2021-09-02T09:30:00+02:00;4;Oberösterreich;12549881;840400;11709481
2021-09-02T09:30:00+02:00;5;Salzburg;5266876;520360;4746516
2021-09-02T09:30:00+02:00;6;Steiermark;10908389;892773;10015616
2021-09-02T09:30:00+02:00;7;Tirol;5875375;1085053;4790322
2021-09-02T09:30:00+02:00;8;Vorarlberg;4433126;280014;4153112
2021-09-02T09:30:00+02:00;9;Wien;16813682;10220749;6592933
2021-09-02T09:30:00+02:00;10;Österreich;77211762;16646638;60565124
2021-09-03T09:30:00+02:00;1;Burgenland;2811914;265674;2546240
2021-09-03T09:30:00+02:00;2;Kärnten;3687129;342776;3344353
2021-09-03T09:30:00+02:00;3;Niederösterreich;14919964;2203185;12716779
2021-09-03T09:30:00+02:00;4;Oberösterreich;12603638;842613;11761025
2021-09-03T09:30:00+02:00;5;Salzburg;5293323;523581;4769742
2021-09-03T09:30:00+02:00;6;Steiermark;10948991;895159;10053832
2021-09-03T09:30:00+02:00;7;Tirol;5882619;1087634;4794985
2021-09-03T09:30:00+02:00;8;Vorarlberg;4446862;280427;4166435
2021-09-03T09:30:00+02:00;9;Wien;16881522;10277654;6603868
2021-09-03T09:30:00+02:00;10;Österreich;77475962;16718703;60757259
2021-09-04T09:30:00+02:00;1;Burgenland;2825467;266100;2559367
2021-09-04T09:30:00+02:00;2;Kärnten;3701932;350963;3350969
2021-09-04T09:30:00+02:00;3;Niederösterreich;14963543;2207262;12756281
2021-09-04T09:30:00+02:00;4;Oberösterreich;12676299;845928;11830371
2021-09-04T09:30:00+02:00;5;Salzburg;5326339;527454;4798885
2021-09-04T09:30:00+02:00;6;Steiermark;11010278;902580;10107698
2021-09-04T09:30:00+02:00;7;Tirol;5893205;1091309;4801896
2021-09-04T09:30:00+02:00;8;Vorarlberg;4464368;280922;4183446
2021-09-04T09:30:00+02:00;9;Wien;16956910;10341325;6615585
2021-09-04T09:30:00+02:00;10;Österreich;77818341;16813843;61004498
2021-09-05T09:30:00+02:00;1;Burgenland;2835065;267606;2567459
2021-09-05T09:30:00+02:00;2;Kärnten;3702223;351254;3350969
2021-09-05T09:30:00+02:00;3;Niederösterreich;15032471;2210822;12821649
2021-09-05T09:30:00+02:00;4;Oberösterreich;12755775;847308;11908467
2021-09-05T09:30:00+02:00;5;Salzburg;5362486;531148;4831338
2021-09-05T09:30:00+02:00;6;Steiermark;11070337;906404;10163933
2021-09-05T09:30:00+02:00;7;Tirol;5901265;1092981;4808284
2021-09-05T09:30:00+02:00;8;Vorarlberg;4481532;281300;4200232
2021-09-05T09:30:00+02:00;9;Wien;17052586;10423231;6629355
2021-09-05T09:30:00+02:00;10;Österreich;78193740;16912054;61281686
2021-09-06T09:30:00+02:00;1;Burgenland;2844120;268589;2575531
2021-09-06T09:30:00+02:00;2;Kärnten;3703069;351705;3351364
2021-09-06T09:30:00+02:00;3;Niederösterreich;15097093;2214319;12882774
2021-09-06T09:30:00+02:00;4;Oberösterreich;12830369;848627;11981742
2021-09-06T09:30:00+02:00;5;Salzburg;5388947;532576;4856371
2021-09-06T09:30:00+02:00;6;Steiermark;11112595;909278;10203317
2021-09-06T09:30:00+02:00;7;Tirol;5908465;1094326;4814139
2021-09-06T09:30:00+02:00;8;Vorarlberg;4496658;281634;4215024
2021-09-06T09:30:00+02:00;9;Wien;17150535;10501894;6648641
2021-09-06T09:30:00+02:00;10;Österreich;78531851;17002948;61528903
2021-09-07T09:30:00+02:00;1;Burgenland;2853390;269655;2583735
2021-09-07T09:30:00+02:00;2;Kärnten;3707505;352327;3355178
2021-09-07T09:30:00+02:00;3;Niederösterreich;15150101;2218030;12932071
2021-09-07T09:30:00+02:00;4;Oberösterreich;12883992;852084;12031908
2021-09-07T09:30:00+02:00;5;Salzburg;5418004;534131;4883873
2021-09-07T09:30:00+02:00;6;Steiermark;11182508;917312;10265196
2021-09-07T09:30:00+02:00;7;Tirol;5915733;1096398;4819335
2021-09-07T09:30:00+02:00;8;Vorarlberg;4510221;282042;4228179
2021-09-07T09:30:00+02:00;9;Wien;17248954;10588587;6660367
2021-09-07T09:30:00+02:00;10;Österreich;78870408;17110566;61759842
2021-09-08T09:30:00+02:00;1;Burgenland;2858841;271129;2587712
2021-09-08T09:30:00+02:00;2;Kärnten;3840576;352893;3487683
2021-09-08T09:30:00+02:00;3;Niederösterreich;15198301;2221480;12976821
2021-09-08T09:30:00+02:00;4;Oberösterreich;12936963;854796;12082167
2021-09-08T09:30:00+02:00;5;Salzburg;5441668;537134;4904534
2021-09-08T09:30:00+02:00;6;Steiermark;11217622;920809;10296813
2021-09-08T09:30:00+02:00;7;Tirol;5925376;1098157;4827219
2021-09-08T09:30:00+02:00;8;Vorarlberg;4523231;282653;4240578
2021-09-08T09:30:00+02:00;9;Wien;17367605;10695047;6672558
2021-09-08T09:30:00+02:00;10;Österreich;79310183;17234098;62076085
2021-09-09T09:30:00+02:00;1;Burgenland;2867134;272085;2595049
2021-09-09T09:30:00+02:00;2;Kärnten;3842540;353510;3489030
2021-09-09T09:30:00+02:00;3;Niederösterreich;15238118;2225814;13012304
2021-09-09T09:30:00+02:00;4;Oberösterreich;13001691;857387;12144304
2021-09-09T09:30:00+02:00;5;Salzburg;5467216;539784;4927432
2021-09-09T09:30:00+02:00;6;Steiermark;11265180;924005;10341175
2021-09-09T09:30:00+02:00;7;Tirol;5931750;1099757;4831993
2021-09-09T09:30:00+02:00;8;Vorarlberg;4538355;283426;4254929
2021-09-09T09:30:00+02:00;9;Wien;17506168;10821070;6685098
2021-09-09T09:30:00+02:00;10;Österreich;79658152;17376838;62281314
2021-09-10T09:30:00+02:00;1;Burgenland;2873236;272996;2600240
2021-09-10T09:30:00+02:00;2;Kärnten;3843819;354038;3489781
2021-09-10T09:30:00+02:00;3;Niederösterreich;15285816;2229472;13056344
2021-09-10T09:30:00+02:00;4;Oberösterreich;13061523;860541;12200982
2021-09-10T09:30:00+02:00;5;Salzburg;5493594;542880;4950714
2021-09-10T09:30:00+02:00;6;Steiermark;11304991;926539;10378452
2021-09-10T09:30:00+02:00;7;Tirol;5939411;1103044;4836367
2021-09-10T09:30:00+02:00;8;Vorarlberg;4551504;283881;4267623
2021-09-10T09:30:00+02:00;9;Wien;17625888;10928876;6697012
2021-09-10T09:30:00+02:00;10;Österreich;79979782;17502267;62477515
2021-09-11T09:30:00+02:00;1;Burgenland;2880690;273144;2607546
2021-09-11T09:30:00+02:00;2;Kärnten;3851122;355417;3495705
2021-09-11T09:30:00+02:00;3;Niederösterreich;15342012;2234041;13107971
2021-09-11T09:30:00+02:00;4;Oberösterreich;13138276;863137;12275139
2021-09-11T09:30:00+02:00;5;Salzburg;5526177;547142;4979035
2021-09-11T09:30:00+02:00;6;Steiermark;11358663;932408;10426255
2021-09-11T09:30:00+02:00;7;Tirol;5949093;1106795;4842298
2021-09-11T09:30:00+02:00;8;Vorarlberg;4568700;284391;4284309
2021-09-11T09:30:00+02:00;9;Wien;17723160;11013701;6709459
2021-09-11T09:30:00+02:00;10;Österreich;80337893;17610176;62727717
2021-09-12T09:30:00+02:00;1;Burgenland;2889014;273488;2615526
2021-09-12T09:30:00+02:00;2;Kärnten;3851520;355815;3495705
2021-09-12T09:30:00+02:00;3;Niederösterreich;15407640;2237753;13169887
2021-09-12T09:30:00+02:00;4;Oberösterreich;13221225;864795;12356430
2021-09-12T09:30:00+02:00;5;Salzburg;5559709;550640;5009069
2021-09-12T09:30:00+02:00;6;Steiermark;11426338;937264;10489074
2021-09-12T09:30:00+02:00;7;Tirol;5956966;1109155;4847811
2021-09-12T09:30:00+02:00;8;Vorarlberg;4586603;284893;4301710
2021-09-12T09:30:00+02:00;9;Wien;17803827;11078260;6725567
2021-09-12T09:30:00+02:00;10;Österreich;80702842;17692063;63010779
2021-09-13T09:30:00+02:00;1;Burgenland;2895490;273687;2621803
2021-09-13T09:30:00+02:00;2;Kärnten;3857313;361608;3495705
2021-09-13T09:30:00+02:00;3;Niederösterreich;15460967;2241392;13219575
2021-09-13T09:30:00+02:00;4;Oberösterreich;13302164;869805;12432359
2021-09-13T09:30:00+02:00;5;Salzburg;5585979;552781;5033198
2021-09-13T09:30:00+02:00;6;Steiermark;11471183;941549;10529634
2021-09-13T09:30:00+02:00;7;Tirol;5965190;1111263;4853927
2021-09-13T09:30:00+02:00;8;Vorarlberg;4601788;285285;4316503
2021-09-13T09:30:00+02:00;9;Wien;17872699;11131021;6741678
2021-09-13T09:30:00+02:00;10;Österreich;81012773;17768391;63244382
2021-09-14T09:30:00+02:00;1;Burgenland;2906451;274021;2632430
2021-09-14T09:30:00+02:00;2;Kärnten;3861808;362226;3499582
2021-09-14T09:30:00+02:00;3;Niederösterreich;15509008;2245844;13263164
2021-09-14T09:30:00+02:00;4;Oberösterreich;13372107;872654;12499453
2021-09-14T09:30:00+02:00;5;Salzburg;5618942;554660;5064282
2021-09-14T09:30:00+02:00;6;Steiermark;11510049;942403;10567646
2021-09-14T09:30:00+02:00;7;Tirol;5971965;1114019;4857946
2021-09-14T09:30:00+02:00;8;Vorarlberg;4616445;286038;4330407
2021-09-14T09:30:00+02:00;9;Wien;18017091;11267442;6749649
2021-09-14T09:30:00+02:00;10;Österreich;81383866;17919307;63464559
2021-09-15T09:30:00+02:00;1;Burgenland;2915519;277897;2637622
2021-09-15T09:30:00+02:00;2;Kärnten;3864029;363110;3500919
2021-09-15T09:30:00+02:00;3;Niederösterreich;15553618;2249898;13303720
2021-09-15T09:30:00+02:00;4;Oberösterreich;13423100;875555;12547545
2021-09-15T09:30:00+02:00;5;Salzburg;5640362;557986;5082376
2021-09-15T09:30:00+02:00;6;Steiermark;11574038;950622;10623416
2021-09-15T09:30:00+02:00;7;Tirol;5992795;1116592;4876203
2021-09-15T09:30:00+02:00;8;Vorarlberg;4627701;286496;4341205
2021-09-15T09:30:00+02:00;9;Wien;18146551;11390472;6756079
2021-09-15T09:30:00+02:00;10;Österreich;81737713;18068628;63669085
2021-09-16T09:30:00+02:00;1;Burgenland;2922746;279109;2643637
2021-09-16T09:30:00+02:00;2;Kärnten;4004331;363825;3640506
2021-09-16T09:30:00+02:00;3;Niederösterreich;15598225;2255225;13343000
2021-09-16T09:30:00+02:00;4;Oberösterreich;13481486;879218;12602268
2021-09-16T09:30:00+02:00;5;Salzburg;5663987;561938;5102049
2021-09-16T09:30:00+02:00;6;Steiermark;11610283;954459;10655824
2021-09-16T09:30:00+02:00;7;Tirol;5999538;1119307;4880231
2021-09-16T09:30:00+02:00;8;Vorarlberg;4640182;287057;4353125
2021-09-16T09:30:00+02:00;9;Wien;18295685;11534115;6761570
2021-09-16T09:30:00+02:00;10;Österreich;82216463;18234253;63982210
2021-09-17T09:30:00+02:00;1;Burgenland;2929891;280061;2649830
2021-09-17T09:30:00+02:00;2;Kärnten;4004956;364450;3640506
2021-09-17T09:30:00+02:00;3;Niederösterreich;15625235;2259723;13365512
2021-09-17T09:30:00+02:00;4;Oberösterreich;13530231;882165;12648066
2021-09-17T09:30:00+02:00;5;Salzburg;5685658;565389;5120269
2021-09-17T09:30:00+02:00;6;Steiermark;11646807;960983;10685824
2021-09-17T09:30:00+02:00;7;Tirol;6007686;1123382;4884304
2021-09-17T09:30:00+02:00;8;Vorarlberg;4651945;287914;4364031
2021-09-17T09:30:00+02:00;9;Wien;18418311;11651524;6766787
2021-09-17T09:30:00+02:00;10;Österreich;82500720;18375591;64125129
2021-09-18T09:30:00+02:00;1;Burgenland;2943253;281509;2661744
2021-09-18T09:30:00+02:00;2;Kärnten;4014463;368675;3645788
2021-09-18T09:30:00+02:00;3;Niederösterreich;15686855;2265488;13421367
2021-09-18T09:30:00+02:00;4;Oberösterreich;13589794;887621;12702173
2021-09-18T09:30:00+02:00;5;Salzburg;5715099;570510;5144589
2021-09-18T09:30:00+02:00;6;Steiermark;11694848;967024;10727824
2021-09-18T09:30:00+02:00;7;Tirol;6017534;1128333;4889201
2021-09-18T09:30:00+02:00;8;Vorarlberg;4667485;288710;4378775
2021-09-18T09:30:00+02:00;9;Wien;18539101;11766765;6772336
2021-09-18T09:30:00+02:00;10;Österreich;82868432;18524635;64343797
2021-09-19T09:30:00+02:00;1;Burgenland;2951861;283036;2668825
2021-09-19T09:30:00+02:00;2;Kärnten;4014910;369122;3645788
2021-09-19T09:30:00+02:00;3;Niederösterreich;15751164;2270494;13480670
2021-09-19T09:30:00+02:00;4;Oberösterreich;13684123;891668;12792455
2021-09-19T09:30:00+02:00;5;Salzburg;5752384;575736;5176648
2021-09-19T09:30:00+02:00;6;Steiermark;11753219;974140;10779079
2021-09-19T09:30:00+02:00;7;Tirol;6025767;1130636;4895131
2021-09-19T09:30:00+02:00;8;Vorarlberg;4685680;289032;4396648
2021-09-19T09:30:00+02:00;9;Wien;18623646;11843240;6780406
2021-09-19T09:30:00+02:00;10;Österreich;83242754;18627104;64615650
2021-09-20T09:30:00+02:00;1;Burgenland;2959636;285237;2674399
2021-09-20T09:30:00+02:00;2;Kärnten;4015445;369657;3645788
2021-09-20T09:30:00+02:00;3;Niederösterreich;15803736;2275813;13527923
2021-09-20T09:30:00+02:00;4;Oberösterreich;13757744;895127;12862617
2021-09-20T09:30:00+02:00;5;Salzburg;5779669;579173;5200496
2021-09-20T09:30:00+02:00;6;Steiermark;11787037;975529;10811508
2021-09-20T09:30:00+02:00;7;Tirol;6034421;1133499;4900922
2021-09-20T09:30:00+02:00;8;Vorarlberg;4697416;289799;4407617
2021-09-20T09:30:00+02:00;9;Wien;18687051;11897395;6789656
2021-09-20T09:30:00+02:00;10;Österreich;83522155;18701229;64820926
2021-09-21T09:30:00+02:00;1;Burgenland;2968311;286747;2681564
2021-09-21T09:30:00+02:00;2;Kärnten;4022729;370339;3652390
2021-09-21T09:30:00+02:00;3;Niederösterreich;15846419;2280107;13566312
2021-09-21T09:30:00+02:00;4;Oberösterreich;13811345;898369;12912976
2021-09-21T09:30:00+02:00;5;Salzburg;5807107;581042;5226065
2021-09-21T09:30:00+02:00;6;Steiermark;11825291;981896;10843395
2021-09-21T09:30:00+02:00;7;Tirol;6041289;1136484;4904805
2021-09-21T09:30:00+02:00;8;Vorarlberg;4710804;290389;4420415
2021-09-21T09:30:00+02:00;9;Wien;18751286;11955040;6796246
2021-09-21T09:30:00+02:00;10;Österreich;83784581;18780413;65004168
2021-09-22T09:30:00+02:00;1;Burgenland;2974163;287553;2686610
2021-09-22T09:30:00+02:00;2;Kärnten;4024379;371185;3653194
2021-09-22T09:30:00+02:00;3;Niederösterreich;15890440;2284896;13605544
2021-09-22T09:30:00+02:00;4;Oberösterreich;13859689;901590;12958099
2021-09-22T09:30:00+02:00;5;Salzburg;5832225;586218;5246007
2021-09-22T09:30:00+02:00;6;Steiermark;11900088;997286;10902802
2021-09-22T09:30:00+02:00;7;Tirol;6048221;1139936;4908285
2021-09-22T09:30:00+02:00;8;Vorarlberg;4722817;291347;4431470
2021-09-22T09:30:00+02:00;9;Wien;18980544;12177800;6802744
2021-09-22T09:30:00+02:00;10;Österreich;84232566;19037811;65194755
2021-09-23T09:30:00+02:00;1;Burgenland;2981986;290042;2691944
2021-09-23T09:30:00+02:00;2;Kärnten;4163946;371989;3791957
2021-09-23T09:30:00+02:00;3;Niederösterreich;15930817;2291248;13639569
2021-09-23T09:30:00+02:00;4;Oberösterreich;13918895;906052;13012843
2021-09-23T09:30:00+02:00;5;Salzburg;5856754;590898;5265856
2021-09-23T09:30:00+02:00;6;Steiermark;11936660;1003772;10932888
2021-09-23T09:30:00+02:00;7;Tirol;6065291;1142628;4922663
2021-09-23T09:30:00+02:00;8;Vorarlberg;4735522;291932;4443590
2021-09-23T09:30:00+02:00;9;Wien;19140051;12330970;6809081
2021-09-23T09:30:00+02:00;10;Österreich;84729922;19219531;65510391
2021-09-24T09:30:00+02:00;1;Burgenland;2987236;290344;2696892
2021-09-24T09:30:00+02:00;2;Kärnten;4164685;372728;3791957
2021-09-24T09:30:00+02:00;3;Niederösterreich;15974469;2297601;13676868
2021-09-24T09:30:00+02:00;4;Oberösterreich;13969796;909852;13059944
2021-09-24T09:30:00+02:00;5;Salzburg;5881138;594831;5286307
2021-09-24T09:30:00+02:00;6;Steiermark;11972366;1009165;10963201
2021-09-24T09:30:00+02:00;7;Tirol;6073232;1146521;4926711
2021-09-24T09:30:00+02:00;8;Vorarlberg;4748328;292436;4455892
2021-09-24T09:30:00+02:00;9;Wien;19262797;12447057;6815740
2021-09-24T09:30:00+02:00;10;Österreich;85034047;19360535;65673512
2021-09-25T09:30:00+02:00;1;Burgenland;3000453;292680;2707773
2021-09-25T09:30:00+02:00;2;Kärnten;4174731;377647;3797084
2021-09-25T09:30:00+02:00;3;Niederösterreich;16023008;2302922;13720086
2021-09-25T09:30:00+02:00;4;Oberösterreich;14031301;913279;13118022
2021-09-25T09:30:00+02:00;5;Salzburg;5918756;601797;5316959
2021-09-25T09:30:00+02:00;6;Steiermark;12023418;1019920;11003498
2021-09-25T09:30:00+02:00;7;Tirol;6083368;1152021;4931347
2021-09-25T09:30:00+02:00;8;Vorarlberg;4763825;293203;4470622
2021-09-25T09:30:00+02:00;9;Wien;19368100;12545494;6822606
2021-09-25T09:30:00+02:00;10;Österreich;85386960;19498963;65887997
2021-09-26T09:30:00+02:00;1;Burgenland;3007975;294026;2713949
2021-09-26T09:30:00+02:00;2;Kärnten;4175177;378093;3797084
2021-09-26T09:30:00+02:00;3;Niederösterreich;16083856;2308756;13775100
2021-09-26T09:30:00+02:00;4;Oberösterreich;14108087;914992;13193095
2021-09-26T09:30:00+02:00;5;Salzburg;5954909;605909;5349000
2021-09-26T09:30:00+02:00;6;Steiermark;12082806;1028479;11054327
2021-09-26T09:30:00+02:00;7;Tirol;6092228;1155433;4936795
2021-09-26T09:30:00+02:00;8;Vorarlberg;4781858;293847;4488011
2021-09-26T09:30:00+02:00;9;Wien;19450233;12618771;6831462
2021-09-26T09:30:00+02:00;10;Österreich;85737129;19598306;66138823
2021-09-27T09:30:00+02:00;1;Burgenland;3015843;295776;2720067
2021-09-27T09:30:00+02:00;2;Kärnten;4175823;378739;3797084
2021-09-27T09:30:00+02:00;3;Niederösterreich;16139866;2314037;13825829
2021-09-27T09:30:00+02:00;4;Oberösterreich;14181581;916884;13264697
2021-09-27T09:30:00+02:00;5;Salzburg;5983335;608927;5374408
2021-09-27T09:30:00+02:00;6;Steiermark;12125933;1035326;11090607
2021-09-27T09:30:00+02:00;7;Tirol;6100023;1157993;4942030
2021-09-27T09:30:00+02:00;8;Vorarlberg;4794499;294400;4500099
2021-09-27T09:30:00+02:00;9;Wien;19516672;12674304;6842368
2021-09-27T09:30:00+02:00;10;Österreich;86033575;19676386;66357189
2021-09-28T09:30:00+02:00;1;Burgenland;3024110;297528;2726582
2021-09-28T09:30:00+02:00;2;Kärnten;4182277;379595;3802682
2021-09-28T09:30:00+02:00;3;Niederösterreich;16181333;2319682;13861651
2021-09-28T09:30:00+02:00;4;Oberösterreich;14236904;925717;13311187
2021-09-28T09:30:00+02:00;5;Salzburg;6011103;610839;5400264
2021-09-28T09:30:00+02:00;6;Steiermark;12158956;1037993;11120963
2021-09-28T09:30:00+02:00;7;Tirol;6107191;1161353;4945838
2021-09-28T09:30:00+02:00;8;Vorarlberg;4807727;294789;4512938
2021-09-28T09:30:00+02:00;9;Wien;19682253;12833788;6848465
2021-09-28T09:30:00+02:00;10;Österreich;86391854;19861284;66530570
2021-09-29T09:30:00+02:00;1;Burgenland;3029278;298055;2731223
2021-09-29T09:30:00+02:00;2;Kärnten;4183171;380489;3802682
2021-09-29T09:30:00+02:00;3;Niederösterreich;16223977;2325270;13898707
2021-09-29T09:30:00+02:00;4;Oberösterreich;14286405;929557;13356848
2021-09-29T09:30:00+02:00;5;Salzburg;6034617;615722;5418895
2021-09-29T09:30:00+02:00;6;Steiermark;12233342;1050386;11182956
2021-09-29T09:30:00+02:00;7;Tirol;6129012;1166760;4962252
2021-09-29T09:30:00+02:00;8;Vorarlberg;4819101;295627;4523474
2021-09-29T09:30:00+02:00;9;Wien;19812048;12951172;6860876
2021-09-29T09:30:00+02:00;10;Österreich;86750951;20013038;66737913
2021-09-30T09:30:00+02:00;1;Burgenland;3037057;300556;2736501
2021-09-30T09:30:00+02:00;2;Kärnten;4294149;381116;3913033
2021-09-30T09:30:00+02:00;3;Niederösterreich;16264417;2331742;13932675
2021-09-30T09:30:00+02:00;4;Oberösterreich;14343254;933742;13409512
2021-09-30T09:30:00+02:00;5;Salzburg;6056128;619411;5436717
2021-09-30T09:30:00+02:00;6;Steiermark;12269782;1058169;11211613
2021-09-30T09:30:00+02:00;7;Tirol;6135526;1169775;4965751
2021-09-30T09:30:00+02:00;8;Vorarlberg;4831072;296154;4534918
2021-09-30T09:30:00+02:00;9;Wien;19953434;13079984;6873450
2021-09-30T09:30:00+02:00;10;Österreich;87184819;20170649;67014170
2021-10-01T09:30:00+02:00;1;Burgenland;3042929;301816;2741113
2021-10-01T09:30:00+02:00;2;Kärnten;4295428;382276;3913152
2021-10-01T09:30:00+02:00;3;Niederösterreich;16297684;2336960;13960724
2021-10-01T09:30:00+02:00;4;Oberösterreich;14391026;938123;13452903
2021-10-01T09:30:00+02:00;5;Salzburg;6077355;623272;5454083
2021-10-01T09:30:00+02:00;6;Steiermark;12305676;1063795;11241881
2021-10-01T09:30:00+02:00;7;Tirol;6140747;1171780;4968967
2021-10-01T09:30:00+02:00;8;Vorarlberg;4843066;296776;4546290
2021-10-01T09:30:00+02:00;9;Wien;20081163;13195914;6885249
2021-10-01T09:30:00+02:00;10;Österreich;87475074;20310712;67164362
2021-10-02T09:30:00+02:00;1;Burgenland;3052943;303204;2749739
2021-10-02T09:30:00+02:00;2;Kärnten;4305323;387309;3918014
2021-10-02T09:30:00+02:00;3;Niederösterreich;16347863;2342675;14005188
2021-10-02T09:30:00+02:00;4;Oberösterreich;14448973;942008;13506965
2021-10-02T09:30:00+02:00;5;Salzburg;6103600;628117;5475483
2021-10-02T09:30:00+02:00;6;Steiermark;12352857;1072094;11280763
2021-10-02T09:30:00+02:00;7;Tirol;6150199;1175835;4974364
2021-10-02T09:30:00+02:00;8;Vorarlberg;4858143;297551;4560592
2021-10-02T09:30:00+02:00;9;Wien;20081163;13195914;6885249
2021-10-02T09:30:00+02:00;10;Österreich;87701064;20344707;67356357
2021-10-03T09:30:00+02:00;1;Burgenland;3058457;304722;2753735
2021-10-03T09:30:00+02:00;2;Kärnten;4305917;387903;3918014
2021-10-03T09:30:00+02:00;3;Niederösterreich;16400180;2348634;14051546
2021-10-03T09:30:00+02:00;4;Oberösterreich;14517030;943505;13573525
2021-10-03T09:30:00+02:00;5;Salzburg;6134666;632533;5502133
2021-10-03T09:30:00+02:00;6;Steiermark;12399955;1073082;11326873
2021-10-03T09:30:00+02:00;7;Tirol;6158145;1178662;4979483
2021-10-03T09:30:00+02:00;8;Vorarlberg;4874252;297902;4576350
2021-10-03T09:30:00+02:00;9;Wien;20261186;13353477;6907709
2021-10-03T09:30:00+02:00;10;Österreich;88109788;20520420;67589368
2021-10-04T09:30:00+02:00;1;Burgenland;3062457;305232;2757225
2021-10-04T09:30:00+02:00;2;Kärnten;4306716;388702;3918014
2021-10-04T09:30:00+02:00;3;Niederösterreich;16449658;2353834;14095824
2021-10-04T09:30:00+02:00;4;Oberösterreich;14586432;945790;13640642
2021-10-04T09:30:00+02:00;5;Salzburg;6159640;635563;5524077
2021-10-04T09:30:00+02:00;6;Steiermark;12450394;1087801;11362593
2021-10-04T09:30:00+02:00;7;Tirol;6165018;1180770;4984248
2021-10-04T09:30:00+02:00;8;Vorarlberg;4886927;298393;4588534
2021-10-04T09:30:00+02:00;9;Wien;20329666;13409525;6920141
2021-10-04T09:30:00+02:00;10;Österreich;88396908;20605610;67791298
2021-10-05T09:30:00+02:00;1;Burgenland;3067124;305817;2761307
2021-10-05T09:30:00+02:00;2;Kärnten;4312759;389482;3923277
2021-10-05T09:30:00+02:00;3;Niederösterreich;16490147;2359424;14130723
2021-10-05T09:30:00+02:00;4;Oberösterreich;14640596;952973;13687623
2021-10-05T09:30:00+02:00;5;Salzburg;6186865;637294;5549571
2021-10-05T09:30:00+02:00;6;Steiermark;12483984;1089433;11394551
2021-10-05T09:30:00+02:00;7;Tirol;6181874;1183014;4998860
2021-10-05T09:30:00+02:00;8;Vorarlberg;4898655;298629;4600026
2021-10-05T09:30:00+02:00;9;Wien;20500300;13576393;6923907
2021-10-05T09:30:00+02:00;10;Österreich;88762304;20792459;67969845
2021-10-06T09:30:00+02:00;1;Burgenland;3071452;307643;2763809
2021-10-06T09:30:00+02:00;2;Kärnten;4314091;390499;3923592
2021-10-06T09:30:00+02:00;3;Niederösterreich;16522678;2364644;14158034
2021-10-06T09:30:00+02:00;4;Oberösterreich;14688226;956778;13731448
2021-10-06T09:30:00+02:00;5;Salzburg;6208504;641732;5566772
2021-10-06T09:30:00+02:00;6;Steiermark;12561427;1107868;11453559
2021-10-06T09:30:00+02:00;7;Tirol;6188382;1186427;5001955
2021-10-06T09:30:00+02:00;8;Vorarlberg;4909504;299285;4610219
2021-10-06T09:30:00+02:00;9;Wien;20624639;13697051;6927588
2021-10-06T09:30:00+02:00;10;Österreich;89088903;20951927;68136976
2021-10-07T09:30:00+02:00;1;Burgenland;3075070;308226;2766844
2021-10-07T09:30:00+02:00;2;Kärnten;4424830;392333;4032497
2021-10-07T09:30:00+02:00;3;Niederösterreich;16556955;2370511;14186444
2021-10-07T09:30:00+02:00;4;Oberösterreich;14743316;961059;13782257
2021-10-07T09:30:00+02:00;5;Salzburg;6229571;646121;5583450
2021-10-07T09:30:00+02:00;6;Steiermark;12595975;1115829;11480146
2021-10-07T09:30:00+02:00;7;Tirol;6193940;1188887;5005053
2021-10-07T09:30:00+02:00;8;Vorarlberg;4920736;299892;4620844
2021-10-07T09:30:00+02:00;9;Wien;20781565;13850203;6931362
2021-10-07T09:30:00+02:00;10;Österreich;89521958;21133061;68388897
2021-10-08T09:30:00+02:00;1;Burgenland;3080378;310098;2770280
2021-10-08T09:30:00+02:00;2;Kärnten;4425733;393236;4032497
2021-10-08T09:30:00+02:00;3;Niederösterreich;16590454;2376322;14214132
2021-10-08T09:30:00+02:00;4;Oberösterreich;14788629;965175;13823454
2021-10-08T09:30:00+02:00;5;Salzburg;6249599;649846;5599753
2021-10-08T09:30:00+02:00;6;Steiermark;12631506;1124386;11507120
2021-10-08T09:30:00+02:00;7;Tirol;6200195;1192108;5008087
2021-10-08T09:30:00+02:00;8;Vorarlberg;4931691;300310;4631381
2021-10-08T09:30:00+02:00;9;Wien;20893884;13958970;6934914
2021-10-08T09:30:00+02:00;10;Österreich;89792069;21270451;68521618
2021-10-09T09:30:00+02:00;1;Burgenland;3087422;310416;2777006
2021-10-09T09:30:00+02:00;2;Kärnten;4434697;398180;4036517
2021-10-09T09:30:00+02:00;3;Niederösterreich;16631471;2382300;14249171
2021-10-09T09:30:00+02:00;4;Oberösterreich;14843267;969638;13873629
2021-10-09T09:30:00+02:00;5;Salzburg;6274946;654796;5620150
2021-10-09T09:30:00+02:00;6;Steiermark;12673163;1131235;11541928
2021-10-09T09:30:00+02:00;7;Tirol;6206877;1195071;5011806
2021-10-09T09:30:00+02:00;8;Vorarlberg;4945650;300818;4644832
2021-10-09T09:30:00+02:00;9;Wien;20982018;14043361;6938657
2021-10-09T09:30:00+02:00;10;Österreich;90079511;21385815;68693696
2021-10-10T09:30:00+02:00;1;Burgenland;3092687;312149;2780538
2021-10-10T09:30:00+02:00;2;Kärnten;4435247;398730;4036517
2021-10-10T09:30:00+02:00;3;Niederösterreich;16686269;2388291;14297978
2021-10-10T09:30:00+02:00;4;Oberösterreich;14907321;971044;13936277
2021-10-10T09:30:00+02:00;5;Salzburg;6304475;659428;5645047
2021-10-10T09:30:00+02:00;6;Steiermark;12719455;1140441;11579014
2021-10-10T09:30:00+02:00;7;Tirol;6214094;1198087;5016007
2021-10-10T09:30:00+02:00;8;Vorarlberg;4961531;301198;4660333
2021-10-10T09:30:00+02:00;9;Wien;21056691;14114056;6942635
2021-10-10T09:30:00+02:00;10;Österreich;90377770;21483424;68894346
2021-10-11T09:30:00+02:00;1;Burgenland;3095894;312480;2783414
2021-10-11T09:30:00+02:00;2;Kärnten;4435926;399409;4036517
2021-10-11T09:30:00+02:00;3;Niederösterreich;16737009;2394275;14342734
2021-10-11T09:30:00+02:00;4;Oberösterreich;14963423;972818;13990605
2021-10-11T09:30:00+02:00;5;Salzburg;6325294;662216;5663078
2021-10-11T09:30:00+02:00;6;Steiermark;12750418;1147833;11602585
2021-10-11T09:30:00+02:00;7;Tirol;6220665;1200273;5020392
2021-10-11T09:30:00+02:00;8;Vorarlberg;4973586;301559;4672027
2021-10-11T09:30:00+02:00;9;Wien;21111744;14164150;6947594
2021-10-11T09:30:00+02:00;10;Österreich;90613959;21555013;69058946
2021-10-12T09:30:00+02:00;1;Burgenland;3101880;315150;2786730
2021-10-12T09:30:00+02:00;2;Kärnten;4443051;400153;4042898
2021-10-12T09:30:00+02:00;3;Niederösterreich;16775556;2400509;14375047
2021-10-12T09:30:00+02:00;4;Oberösterreich;15013938;979586;14034352
2021-10-12T09:30:00+02:00;5;Salzburg;6352253;664189;5688064
2021-10-12T09:30:00+02:00;6;Steiermark;12787407;1155763;11631644
2021-10-12T09:30:00+02:00;7;Tirol;6226056;1202498;5023558
2021-10-12T09:30:00+02:00;8;Vorarlberg;4985079;301759;4683320
2021-10-12T09:30:00+02:00;9;Wien;21280543;14329643;6950900
2021-10-12T09:30:00+02:00;10;Österreich;90965763;21749250;69216513
2021-10-13T09:30:00+02:00;1;Burgenland;3105084;315621;2789463
2021-10-13T09:30:00+02:00;2;Kärnten;4444567;401037;4043530
2021-10-13T09:30:00+02:00;3;Niederösterreich;16814733;2407397;14407336
2021-10-13T09:30:00+02:00;4;Oberösterreich;15059006;983432;14075574
2021-10-13T09:30:00+02:00;5;Salzburg;6373460;668862;5704598
2021-10-13T09:30:00+02:00;6;Steiermark;12860683;1164313;11696370
2021-10-13T09:30:00+02:00;7;Tirol;6242087;1205419;5036668
2021-10-13T09:30:00+02:00;8;Vorarlberg;4995756;302104;4693652
2021-10-13T09:30:00+02:00;9;Wien;21399453;14446219;6953234
2021-10-13T09:30:00+02:00;10;Österreich;91294829;21894404;69400425
2021-10-14T09:30:00+02:00;1;Burgenland;3109749;317772;2791977
2021-10-14T09:30:00+02:00;2;Kärnten;4552479;401858;4150621
2021-10-14T09:30:00+02:00;3;Niederösterreich;16842583;2413473;14429110
2021-10-14T09:30:00+02:00;4;Oberösterreich;15112361;987521;14124840
2021-10-14T09:30:00+02:00;5;Salzburg;6394376;673011;5721365
2021-10-14T09:30:00+02:00;6;Steiermark;12895594;1173308;11722286
2021-10-14T09:30:00+02:00;7;Tirol;6247293;1207433;5039860
2021-10-14T09:30:00+02:00;8;Vorarlberg;5006902;302498;4704404
2021-10-14T09:30:00+02:00;9;Wien;21560933;14604496;6956437
2021-10-14T09:30:00+02:00;10;Österreich;91722270;22081370;69640900
2021-10-15T09:30:00+02:00;1;Burgenland;3112432;318128;2794304
2021-10-15T09:30:00+02:00;2;Kärnten;4553305;402684;4150621
2021-10-15T09:30:00+02:00;3;Niederösterreich;16884855;2420091;14464764
2021-10-15T09:30:00+02:00;4;Oberösterreich;15158062;992176;14165886
2021-10-15T09:30:00+02:00;5;Salzburg;6413350;676626;5736724
2021-10-15T09:30:00+02:00;6;Steiermark;12928009;1179411;11748598
2021-10-15T09:30:00+02:00;7;Tirol;6254393;1211347;5043046
2021-10-15T09:30:00+02:00;8;Vorarlberg;5018164;302974;4715190
2021-10-15T09:30:00+02:00;9;Wien;21680550;14721031;6959519
2021-10-15T09:30:00+02:00;10;Österreich;92003120;22224468;69778652
2021-10-16T09:30:00+02:00;1;Burgenland;3121462;318393;2803069
2021-10-16T09:30:00+02:00;2;Kärnten;4561812;407308;4154504
2021-10-16T09:30:00+02:00;3;Niederösterreich;16928121;2427669;14500452
2021-10-16T09:30:00+02:00;4;Oberösterreich;15211571;996302;14215269
2021-10-16T09:30:00+02:00;5;Salzburg;6441038;682295;5758743
2021-10-16T09:30:00+02:00;6;Steiermark;12964880;1182129;11782751
2021-10-16T09:30:00+02:00;7;Tirol;6262076;1215111;5046965
2021-10-16T09:30:00+02:00;8;Vorarlberg;5032127;303374;4728753
2021-10-16T09:30:00+02:00;9;Wien;21801851;14839050;6962801
2021-10-16T09:30:00+02:00;10;Österreich;92324938;22371631;69953307
2021-10-17T09:30:00+02:00;1;Burgenland;3124967;318732;2806235
2021-10-17T09:30:00+02:00;2;Kärnten;4562340;407836;4154504
2021-10-17T09:30:00+02:00;3;Niederösterreich;16974530;2434035;14540495
2021-10-17T09:30:00+02:00;4;Oberösterreich;15273302;997852;14275450
2021-10-17T09:30:00+02:00;5;Salzburg;6468821;687077;5781744
2021-10-17T09:30:00+02:00;6;Steiermark;13020016;1197731;11822285
2021-10-17T09:30:00+02:00;7;Tirol;6268556;1217161;5051395
2021-10-17T09:30:00+02:00;8;Vorarlberg;5047274;303690;4743584
2021-10-17T09:30:00+02:00;9;Wien;21883260;14917055;6966205
2021-10-17T09:30:00+02:00;10;Österreich;92623066;22481169;70141897
2021-10-18T09:30:00+02:00;1;Burgenland;3128190;319003;2809187
2021-10-18T09:30:00+02:00;2;Kärnten;4563048;408544;4154504
2021-10-18T09:30:00+02:00;3;Niederösterreich;17018318;2440728;14577590
2021-10-18T09:30:00+02:00;4;Oberösterreich;15328195;999508;14328687
2021-10-18T09:30:00+02:00;5;Salzburg;6490492;690714;5799778
2021-10-18T09:30:00+02:00;6;Steiermark;13055100;1205215;11849885
2021-10-18T09:30:00+02:00;7;Tirol;6276096;1220268;5055828
2021-10-18T09:30:00+02:00;8;Vorarlberg;5059071;303994;4755077
2021-10-18T09:30:00+02:00;9;Wien;21952963;14982442;6970521
2021-10-18T09:30:00+02:00;10;Österreich;92871473;22570416;70301057
2021-10-19T09:30:00+02:00;1;Burgenland;3133011;320091;2812920
2021-10-19T09:30:00+02:00;2;Kärnten;4567382;409600;4157782
2021-10-19T09:30:00+02:00;3;Niederösterreich;17063131;2452857;14610274
2021-10-19T09:30:00+02:00;4;Oberösterreich;15375744;1007366;14368378
2021-10-19T09:30:00+02:00;5;Salzburg;6518907;693113;5825794
2021-10-19T09:30:00+02:00;6;Steiermark;13090903;1211429;11879474
2021-10-19T09:30:00+02:00;7;Tirol;6276096;1220268;5055828
2021-10-19T09:30:00+02:00;8;Vorarlberg;5070748;304395;4766353
2021-10-19T09:30:00+02:00;9;Wien;22140441;15166558;6973883
2021-10-19T09:30:00+02:00;10;Österreich;93236363;22785677;70450686
2021-10-20T09:30:00+02:00;1;Burgenland;3135860;320617;2815243
2021-10-20T09:30:00+02:00;2;Kärnten;4572840;410672;4162168
2021-10-20T09:30:00+02:00;3;Niederösterreich;17098479;2462443;14636036
2021-10-20T09:30:00+02:00;4;Oberösterreich;15426356;1012410;14413946
2021-10-20T09:30:00+02:00;5;Salzburg;6539131;697232;5841899
2021-10-20T09:30:00+02:00;6;Steiermark;13165412;1223970;11941442
2021-10-20T09:30:00+02:00;7;Tirol;6289007;1226688;5062319
2021-10-20T09:30:00+02:00;8;Vorarlberg;5081435;304994;4776441
2021-10-20T09:30:00+02:00;9;Wien;22263218;15287464;6975754
2021-10-20T09:30:00+02:00;10;Österreich;93571738;22946490;70625248
2021-10-21T09:30:00+02:00;1;Burgenland;3139198;321299;2817899
2021-10-21T09:30:00+02:00;2;Kärnten;4673453;411939;4261514
2021-10-21T09:30:00+02:00;3;Niederösterreich;17145124;2470890;14674234
2021-10-21T09:30:00+02:00;4;Oberösterreich;15481035;1017092;14463943
2021-10-21T09:30:00+02:00;5;Salzburg;6566082;703973;5862109
2021-10-21T09:30:00+02:00;6;Steiermark;13200327;1231530;11968797
2021-10-21T09:30:00+02:00;7;Tirol;6307111;1230093;5077018
2021-10-21T09:30:00+02:00;8;Vorarlberg;5093003;305537;4787466
2021-10-21T09:30:00+02:00;9;Wien;22421570;15442930;6978640
2021-10-21T09:30:00+02:00;10;Österreich;94026903;23135283;70891620
2021-10-22T09:30:00+02:00;1;Burgenland;3152871;332597;2820274
2021-10-22T09:30:00+02:00;2;Kärnten;4674562;413048;4261514
2021-10-22T09:30:00+02:00;3;Niederösterreich;17184198;2480352;14703846
2021-10-22T09:30:00+02:00;4;Oberösterreich;15526885;1022722;14504163
2021-10-22T09:30:00+02:00;5;Salzburg;6589814;710077;5879737
2021-10-22T09:30:00+02:00;6;Steiermark;13239058;1241966;11997092
2021-10-22T09:30:00+02:00;7;Tirol;6314603;1234041;5080562
2021-10-22T09:30:00+02:00;8;Vorarlberg;5104144;306148;4797996
2021-10-22T09:30:00+02:00;9;Wien;22525612;15544706;6980906
2021-10-22T09:30:00+02:00;10;Österreich;94311747;23285657;71026090
2021-10-23T09:30:00+02:00;1;Burgenland;3161759;332972;2828787
2021-10-23T09:30:00+02:00;2;Kärnten;4679385;417871;4261514
2021-10-23T09:30:00+02:00;3;Niederösterreich;17229035;2489530;14739505
2021-10-23T09:30:00+02:00;4;Oberösterreich;15582379;1028792;14553587
2021-10-23T09:30:00+02:00;5;Salzburg;6618768;716966;5901802
2021-10-23T09:30:00+02:00;6;Steiermark;13284978;1252329;12032649
2021-10-23T09:30:00+02:00;7;Tirol;6324026;1238930;5085096
2021-10-23T09:30:00+02:00;8;Vorarlberg;5118236;306740;4811496
2021-10-23T09:30:00+02:00;9;Wien;22629170;15645703;6983467
2021-10-23T09:30:00+02:00;10;Österreich;94627736;23429833;71197903
2021-10-24T09:30:00+02:00;1;Burgenland;3167118;335144;2831974
2021-10-24T09:30:00+02:00;2;Kärnten;4682866;417925;4264941
2021-10-24T09:30:00+02:00;3;Niederösterreich;17282347;2498412;14783935
2021-10-24T09:30:00+02:00;4;Oberösterreich;15643295;1031448;14611847
2021-10-24T09:30:00+02:00;5;Salzburg;6652040;724676;5927364
2021-10-24T09:30:00+02:00;6;Steiermark;13335365;1263050;12072315
2021-10-24T09:30:00+02:00;7;Tirol;6331933;1242250;5089683
2021-10-24T09:30:00+02:00;8;Vorarlberg;5133157;307532;4825625
2021-10-24T09:30:00+02:00;9;Wien;22713854;15727808;6986046
2021-10-24T09:30:00+02:00;10;Österreich;94941975;23548245;71393730
2021-10-25T09:30:00+02:00;1;Burgenland;3170388;335458;2834930
2021-10-25T09:30:00+02:00;2;Kärnten;4686314;421373;4264941
2021-10-25T09:30:00+02:00;3;Niederösterreich;17333233;2509175;14824058
2021-10-25T09:30:00+02:00;4;Oberösterreich;15699772;1033732;14666040
2021-10-25T09:30:00+02:00;5;Salzburg;6675755;728903;5946852
2021-10-25T09:30:00+02:00;6;Steiermark;13371714;1273289;12098425
2021-10-25T09:30:00+02:00;7;Tirol;6340079;1245939;5094140
2021-10-25T09:30:00+02:00;8;Vorarlberg;5145195;308239;4836956
2021-10-25T09:30:00+02:00;9;Wien;22765321;15775947;6989374
2021-10-25T09:30:00+02:00;10;Österreich;95187771;23632055;71555716
2021-10-26T09:30:00+02:00;1;Burgenland;3182781;342782;2839999
2021-10-26T09:30:00+02:00;2;Kärnten;4689009;422684;4266325
2021-10-26T09:30:00+02:00;3;Niederösterreich;17386062;2519226;14866836
2021-10-26T09:30:00+02:00;4;Oberösterreich;15769713;1036533;14733180
2021-10-26T09:30:00+02:00;5;Salzburg;6709469;732592;5976877
2021-10-26T09:30:00+02:00;6;Steiermark;13425226;1275095;12150131
2021-10-26T09:30:00+02:00;7;Tirol;6359670;1250338;5109332
2021-10-26T09:30:00+02:00;8;Vorarlberg;5157889;308820;4849069
2021-10-26T09:30:00+02:00;9;Wien;22861981;15869779;6992202
2021-10-26T09:30:00+02:00;10;Österreich;95541800;23757849;71783951
2021-10-27T09:30:00+02:00;1;Burgenland;3186822;343089;2843733
2021-10-27T09:30:00+02:00;2;Kärnten;4692552;423660;4268892
2021-10-27T09:30:00+02:00;3;Niederösterreich;17439778;2529064;14910714
2021-10-27T09:30:00+02:00;4;Oberösterreich;15820668;1039328;14781340
2021-10-27T09:30:00+02:00;5;Salzburg;6737197;738655;5998542
2021-10-27T09:30:00+02:00;6;Steiermark;13469105;1287064;12182041
2021-10-27T09:30:00+02:00;7;Tirol;6367686;1253881;5113805
2021-10-27T09:30:00+02:00;8;Vorarlberg;5170016;309811;4860205
2021-10-27T09:30:00+02:00;9;Wien;22926575;15929417;6997158
2021-10-27T09:30:00+02:00;10;Österreich;95810399;23853969;71956430
2021-10-28T09:30:00+02:00;1;Burgenland;3194230;346352;2847878
2021-10-28T09:30:00+02:00;2;Kärnten;4785987;425554;4360433
2021-10-28T09:30:00+02:00;3;Niederösterreich;17494065;2540851;14953214
2021-10-28T09:30:00+02:00;4;Oberösterreich;15888392;1045793;14842599
2021-10-28T09:30:00+02:00;5;Salzburg;6762893;743835;6019058
2021-10-28T09:30:00+02:00;6;Steiermark;13540767;1304833;12235934
2021-10-28T09:30:00+02:00;7;Tirol;6376035;1258474;5117561
2021-10-28T09:30:00+02:00;8;Vorarlberg;5182588;310636;4871952
2021-10-28T09:30:00+02:00;9;Wien;23037437;16035685;7001752
2021-10-28T09:30:00+02:00;10;Österreich;96262394;24012013;72250381
2021-10-29T09:30:00+02:00;1;Burgenland;3198185;346664;2851521
2021-10-29T09:30:00+02:00;2;Kärnten;4787752;426907;4360845
2021-10-29T09:30:00+02:00;3;Niederösterreich;17540989;2553072;14987917
2021-10-29T09:30:00+02:00;4;Oberösterreich;15945230;1052775;14892455
2021-10-29T09:30:00+02:00;5;Salzburg;6791668;751499;6040169
2021-10-29T09:30:00+02:00;6;Steiermark;13584678;1313829;12270849
2021-10-29T09:30:00+02:00;7;Tirol;6383536;1262607;5120929
2021-10-29T09:30:00+02:00;8;Vorarlberg;5195154;311828;4883326
2021-10-29T09:30:00+02:00;9;Wien;23148129;16142482;7005647
2021-10-29T09:30:00+02:00;10;Österreich;96575321;24161663;72413658
2021-10-30T09:30:00+02:00;1;Burgenland;3209588;349774;2859814
2021-10-30T09:30:00+02:00;2;Kärnten;4789144;428299;4360845
2021-10-30T09:30:00+02:00;3;Niederösterreich;17607188;2565287;15041901
2021-10-30T09:30:00+02:00;4;Oberösterreich;16011294;1059179;14952115
2021-10-30T09:30:00+02:00;5;Salzburg;6822135;758154;6063981
2021-10-30T09:30:00+02:00;6;Steiermark;13636079;1325809;12310270
2021-10-30T09:30:00+02:00;7;Tirol;6393555;1268348;5125207
2021-10-30T09:30:00+02:00;8;Vorarlberg;5209129;312867;4896262
2021-10-30T09:30:00+02:00;9;Wien;23235629;16226056;7009573
2021-10-30T09:30:00+02:00;10;Österreich;96913741;24293773;72619968
2021-10-31T09:30:00+01:00;1;Burgenland;3212999;350132;2862867
2021-10-31T09:30:00+01:00;2;Kärnten;4795173;434328;4360845
2021-10-31T09:30:00+01:00;3;Niederösterreich;17665463;2577208;15088255
2021-10-31T09:30:00+01:00;4;Oberösterreich;16076693;1062283;15014410
2021-10-31T09:30:00+01:00;5;Salzburg;6855801;768004;6087797
2021-10-31T09:30:00+01:00;6;Steiermark;13688518;1338194;12350324
2021-10-31T09:30:00+01:00;7;Tirol;6401948;1272479;5129469
2021-10-31T09:30:00+01:00;8;Vorarlberg;5223677;313931;4909746
2021-10-31T09:30:00+01:00;9;Wien;23334330;16320650;7013680
2021-10-31T09:30:00+01:00;10;Österreich;97254602;24437209;72817393
2021-11-01T09:30:00+01:00;1;Burgenland;3216513;350723;2865790
2021-11-01T09:30:00+01:00;2;Kärnten;4801002;435459;4365543
2021-11-01T09:30:00+01:00;3;Niederösterreich;17720008;2588299;15131709
2021-11-01T09:30:00+01:00;4;Oberösterreich;16143528;1065782;15077746
2021-11-01T09:30:00+01:00;5;Salzburg;6883440;774985;6108455
2021-11-01T09:30:00+01:00;6;Steiermark;13731693;1353556;12378137
2021-11-01T09:30:00+01:00;7;Tirol;6410093;1276618;5133475
2021-11-01T09:30:00+01:00;8;Vorarlberg;5235619;314665;4920954
2021-11-01T09:30:00+01:00;9;Wien;23389206;16370399;7018807
2021-11-01T09:30:00+01:00;10;Österreich;97531102;24530486;73000616
2021-11-02T09:30:00+01:00;1;Burgenland;3220759;351917;2868842
2021-11-02T09:30:00+01:00;2;Kärnten;4803126;436672;4366454
2021-11-02T09:30:00+01:00;3;Niederösterreich;17777799;2600806;15176993
2021-11-02T09:30:00+01:00;4;Oberösterreich;16217627;1068610;15149017
2021-11-02T09:30:00+01:00;5;Salzburg;6907480;779401;6128079
2021-11-02T09:30:00+01:00;6;Steiermark;13772660;1355774;12416886
2021-11-02T09:30:00+01:00;7;Tirol;6422593;1282863;5139730
2021-11-02T09:30:00+01:00;8;Vorarlberg;5248174;315549;4932625
2021-11-02T09:30:00+01:00;9;Wien;23467266;16442652;7024614
2021-11-02T09:30:00+01:00;10;Österreich;97837484;24634244;73203240
2021-11-03T09:30:00+01:00;1;Burgenland;3233425;359421;2874004
2021-11-03T09:30:00+01:00;2;Kärnten;4811930;438851;4373079
2021-11-03T09:30:00+01:00;3;Niederösterreich;17868237;2619361;15248876
2021-11-03T09:30:00+01:00;4;Oberösterreich;16340102;1081129;15258973
2021-11-03T09:30:00+01:00;5;Salzburg;6957249;787834;6169415
2021-11-03T09:30:00+01:00;6;Steiermark;13867663;1379045;12488618
2021-11-03T09:30:00+01:00;7;Tirol;6432860;1288114;5144746
2021-11-03T09:30:00+01:00;8;Vorarlberg;5267387;316482;4950905
2021-11-03T09:30:00+01:00;9;Wien;23639958;16609976;7029982
2021-11-03T09:30:00+01:00;10;Österreich;98418811;24880213;73538598
2021-11-04T09:30:00+01:00;1;Burgenland;3238936;360333;2878603
2021-11-04T09:30:00+01:00;2;Kärnten;4820807;440288;4380519
2021-11-04T09:30:00+01:00;3;Niederösterreich;17938778;2634450;15304328
2021-11-04T09:30:00+01:00;4;Oberösterreich;16450678;1091159;15359519
2021-11-04T09:30:00+01:00;5;Salzburg;6999136;802600;6196536
2021-11-04T09:30:00+01:00;6;Steiermark;13929762;1397582;12532180
2021-11-04T09:30:00+01:00;7;Tirol;6443009;1293664;5149345
2021-11-04T09:30:00+01:00;8;Vorarlberg;5284911;317585;4967326
2021-11-04T09:30:00+01:00;9;Wien;23862973;16829567;7033406
2021-11-04T09:30:00+01:00;10;Österreich;98968990;25167228;73801762
2021-11-05T09:30:00+01:00;1;Burgenland;3246963;365054;2881909
2021-11-05T09:30:00+01:00;2;Kärnten;4823398;442879;4380519
2021-11-05T09:30:00+01:00;3;Niederösterreich;18008516;2650198;15358318
2021-11-05T09:30:00+01:00;4;Oberösterreich;16550120;1101956;15448164
2021-11-05T09:30:00+01:00;5;Salzburg;7036044;814863;6221181
2021-11-05T09:30:00+01:00;6;Steiermark;13991303;1419724;12571579
2021-11-05T09:30:00+01:00;7;Tirol;6453312;1299593;5153719
2021-11-05T09:30:00+01:00;8;Vorarlberg;5302034;319309;4982725
2021-11-05T09:30:00+01:00;9;Wien;24030602;16993854;7036748
2021-11-05T09:30:00+01:00;10;Österreich;99442292;25407430;74034862
2021-11-06T09:30:00+01:00;1;Burgenland;3257357;367922;2889435
2021-11-06T09:30:00+01:00;2;Kärnten;4825373;444854;4380519
2021-11-06T09:30:00+01:00;3;Niederösterreich;18082252;2669839;15412413
2021-11-06T09:30:00+01:00;4;Oberösterreich;16637553;1108517;15529036
2021-11-06T09:30:00+01:00;5;Salzburg;7071784;825784;6246000
2021-11-06T09:30:00+01:00;6;Steiermark;14032909;1422603;12610306
2021-11-06T09:30:00+01:00;7;Tirol;6463859;1305816;5158043
2021-11-06T09:30:00+01:00;8;Vorarlberg;5318632;320782;4997850
2021-11-06T09:30:00+01:00;9;Wien;24167488;17127335;7040153
2021-11-06T09:30:00+01:00;10;Österreich;99857207;25593452;74263755
2021-11-07T09:30:00+01:00;1;Burgenland;3267806;375701;2892105
2021-11-07T09:30:00+01:00;2;Kärnten;4836903;452103;4384800
2021-11-07T09:30:00+01:00;3;Niederösterreich;18145213;2687062;15458151
2021-11-07T09:30:00+01:00;4;Oberösterreich;16711252;1112905;15598347
2021-11-07T09:30:00+01:00;5;Salzburg;7107785;839291;6268494
2021-11-07T09:30:00+01:00;6;Steiermark;14102367;1436049;12666318
2021-11-07T09:30:00+01:00;7;Tirol;6472657;1310041;5162616
2021-11-07T09:30:00+01:00;8;Vorarlberg;5333608;321993;5011615
2021-11-07T09:30:00+01:00;9;Wien;24276884;17233495;7043389
2021-11-07T09:30:00+01:00;10;Österreich;100254475;25768640;74485835
2021-11-08T09:30:00+01:00;1;Burgenland;3273065;378369;2894696
2021-11-08T09:30:00+01:00;2;Kärnten;4838795;453871;4384924
2021-11-08T09:30:00+01:00;3;Niederösterreich;18205766;2705318;15500448
2021-11-08T09:30:00+01:00;4;Oberösterreich;16817061;1151990;15665071
2021-11-08T09:30:00+01:00;5;Salzburg;7135128;848425;6286703
2021-11-08T09:30:00+01:00;6;Steiermark;14150772;1455631;12695141
2021-11-08T09:30:00+01:00;7;Tirol;6487211;1318521;5168690
2021-11-08T09:30:00+01:00;8;Vorarlberg;5345444;323092;5022352
2021-11-08T09:30:00+01:00;9;Wien;24382203;17334510;7047693
2021-11-08T09:30:00+01:00;10;Österreich;100635445;25969727;74665718
2021-11-09T09:30:00+01:00;1;Burgenland;3281836;384172;2897664
2021-11-09T09:30:00+01:00;2;Kärnten;4846369;456841;4389528
2021-11-09T09:30:00+01:00;3;Niederösterreich;18241844;2724662;15517182
2021-11-09T09:30:00+01:00;4;Oberösterreich;16877030;1180946;15696084
2021-11-09T09:30:00+01:00;5;Salzburg;7179867;861326;6318541
2021-11-09T09:30:00+01:00;6;Steiermark;14186463;1473306;12713157
2021-11-09T09:30:00+01:00;7;Tirol;6521327;1329134;5192193
2021-11-09T09:30:00+01:00;8;Vorarlberg;5351085;324310;5026775
2021-11-09T09:30:00+01:00;9;Wien;24604582;17553389;7051193
2021-11-09T09:30:00+01:00;10;Österreich;101090403;26288086;74802317
2021-11-10T09:30:00+01:00;1;Burgenland;3285723;385034;2900689
2021-11-10T09:30:00+01:00;2;Kärnten;4848749;459221;4389528
2021-11-10T09:30:00+01:00;3;Niederösterreich;18280183;2744334;15535849
2021-11-10T09:30:00+01:00;4;Oberösterreich;16947818;1224462;15723356
2021-11-10T09:30:00+01:00;5;Salzburg;7215636;877052;6338584
2021-11-10T09:30:00+01:00;6;Steiermark;14219760;1482362;12737398
2021-11-10T09:30:00+01:00;7;Tirol;6533809;1337501;5196308
2021-11-10T09:30:00+01:00;8;Vorarlberg;5356545;326205;5030340
2021-11-10T09:30:00+01:00;9;Wien;24782476;17727655;7054821
2021-11-10T09:30:00+01:00;10;Österreich;101470699;26563826;74906873
2021-11-11T09:30:00+01:00;1;Burgenland;3289400;386276;2903124
2021-11-11T09:30:00+01:00;2;Kärnten;5101210;462133;4639077
2021-11-11T09:30:00+01:00;3;Niederösterreich;18313876;2765332;15548544
2021-11-11T09:30:00+01:00;4;Oberösterreich;16993952;1257726;15736226
2021-11-11T09:30:00+01:00;5;Salzburg;7255994;895639;6360355
2021-11-11T09:30:00+01:00;6;Steiermark;14278061;1502190;12775871
2021-11-11T09:30:00+01:00;7;Tirol;6544996;1344943;5200053
2021-11-11T09:30:00+01:00;8;Vorarlberg;5361944;327964;5033980
2021-11-11T09:30:00+01:00;9;Wien;25023923;17966006;7057917
2021-11-11T09:30:00+01:00;10;Österreich;102163356;26908209;75255147
2021-11-12T09:30:00+01:00;1;Burgenland;3295668;390711;2904957
2021-11-12T09:30:00+01:00;2;Kärnten;5120178;481101;4639077
2021-11-12T09:30:00+01:00;3;Niederösterreich;18345278;2786269;15559009
2021-11-12T09:30:00+01:00;4;Oberösterreich;17036127;1287676;15748451
2021-11-12T09:30:00+01:00;5;Salzburg;7297944;915702;6382242
2021-11-12T09:30:00+01:00;6;Steiermark;14356213;1567104;12789109
2021-11-12T09:30:00+01:00;7;Tirol;6557609;1353516;5204093
2021-11-12T09:30:00+01:00;8;Vorarlberg;5367808;329755;5038053
2021-11-12T09:30:00+01:00;9;Wien;25231747;18170660;7061087
2021-11-12T09:30:00+01:00;10;Österreich;102608572;27282494;75326078
2021-11-13T09:30:00+01:00;1;Burgenland;3308189;399853;2908336
2021-11-13T09:30:00+01:00;2;Kärnten;5136111;492332;4643779
2021-11-13T09:30:00+01:00;3;Niederösterreich;18378067;2806836;15571231
2021-11-13T09:30:00+01:00;4;Oberösterreich;17079123;1321367;15757756
2021-11-13T09:30:00+01:00;5;Salzburg;7330739;932878;6397861
2021-11-13T09:30:00+01:00;6;Steiermark;14392508;1590599;12801909
2021-11-13T09:30:00+01:00;7;Tirol;6571248;1364342;5206906
2021-11-13T09:30:00+01:00;8;Vorarlberg;5372734;331475;5041259
2021-11-13T09:30:00+01:00;9;Wien;25421387;18357432;7063955
2021-11-13T09:30:00+01:00;10;Österreich;102990106;27597114;75392992
2021-11-14T09:30:00+01:00;1;Burgenland;3315401;406308;2909093
2021-11-14T09:30:00+01:00;2;Kärnten;5137019;493240;4643779
2021-11-14T09:30:00+01:00;3;Niederösterreich;18406400;2827355;15579045
2021-11-14T09:30:00+01:00;4;Oberösterreich;17117177;1355318;15761859
2021-11-14T09:30:00+01:00;5;Salzburg;7369269;956005;6413264
2021-11-14T09:30:00+01:00;6;Steiermark;14409834;1597545;12812289
2021-11-14T09:30:00+01:00;7;Tirol;6583645;1374095;5209550
2021-11-14T09:30:00+01:00;8;Vorarlberg;5376589;333556;5043033
2021-11-14T09:30:00+01:00;9;Wien;25598185;18531669;7066516
2021-11-14T09:30:00+01:00;10;Österreich;103313519;27875091;75438428
2021-11-15T09:30:00+01:00;1;Burgenland;3323210;413140;2910070
2021-11-15T09:30:00+01:00;2;Kärnten;5139268;495374;4643894
2021-11-15T09:30:00+01:00;3;Niederösterreich;18437704;2848902;15588802
2021-11-15T09:30:00+01:00;4;Oberösterreich;17165517;1393475;15772042
2021-11-15T09:30:00+01:00;5;Salzburg;7403150;975261;6427889
2021-11-15T09:30:00+01:00;6;Steiermark;14502388;1689391;12812997
2021-11-15T09:30:00+01:00;7;Tirol;6598291;1383133;5215158
2021-11-15T09:30:00+01:00;8;Vorarlberg;5380312;335082;5045230
2021-11-15T09:30:00+01:00;9;Wien;25763477;18693148;7070329
2021-11-15T09:30:00+01:00;10;Österreich;103713317;28226906;75486411
2021-11-16T09:30:00+01:00;1;Burgenland;3331642;419065;2912577
2021-11-16T09:30:00+01:00;2;Kärnten;5149249;498863;4650386
2021-11-16T09:30:00+01:00;3;Niederösterreich;18474759;2867552;15607207
2021-11-16T09:30:00+01:00;4;Oberösterreich;17232699;1440475;15792224
2021-11-16T09:30:00+01:00;5;Salzburg;7444556;990547;6454009
2021-11-16T09:30:00+01:00;6;Steiermark;14524122;1690196;12833926
2021-11-16T09:30:00+01:00;7;Tirol;6632569;1398279;5234290
2021-11-16T09:30:00+01:00;8;Vorarlberg;5386990;337176;5049814
2021-11-16T09:30:00+01:00;9;Wien;26001271;18927322;7073949
2021-11-16T09:30:00+01:00;10;Österreich;104177857;28569475;75608382
2021-11-17T09:30:00+01:00;1;Burgenland;3336612;422990;2913622
2021-11-17T09:30:00+01:00;2;Kärnten;5153192;501203;4651989
2021-11-17T09:30:00+01:00;3;Niederösterreich;18516341;2887389;15628952
2021-11-17T09:30:00+01:00;4;Oberösterreich;17289821;1480618;15809203
2021-11-17T09:30:00+01:00;5;Salzburg;7490251;1016177;6474074
2021-11-17T09:30:00+01:00;6;Steiermark;14598880;1712700;12886180
2021-11-17T09:30:00+01:00;7;Tirol;6648615;1409993;5238622
2021-11-17T09:30:00+01:00;8;Vorarlberg;5393329;339460;5053869
2021-11-17T09:30:00+01:00;9;Wien;26344250;19267755;7076495
2021-11-17T09:30:00+01:00;10;Österreich;104771291;29038285;75733006
2021-11-18T09:30:00+01:00;1;Burgenland;3346659;431335;2915324
2021-11-18T09:30:00+01:00;2;Kärnten;5183352;522209;4661143
2021-11-18T09:30:00+01:00;3;Niederösterreich;18551139;2906796;15644343
2021-11-18T09:30:00+01:00;4;Oberösterreich;17370333;1522930;15847403
2021-11-18T09:30:00+01:00;5;Salzburg;7535988;1040037;6495951
2021-11-18T09:30:00+01:00;6;Steiermark;14663759;1761561;12902198
2021-11-18T09:30:00+01:00;7;Tirol;6664904;1421958;5242946
2021-11-18T09:30:00+01:00;8;Vorarlberg;5400212;342367;5057845
2021-11-18T09:30:00+01:00;9;Wien;26608839;19529197;7079642
2021-11-18T09:30:00+01:00;10;Österreich;105325185;29478390;75846795
2021-11-19T09:30:00+01:00;1;Burgenland;3358872;442080;2916792
2021-11-19T09:30:00+01:00;2;Kärnten;5200744;539601;4661143
2021-11-19T09:30:00+01:00;3;Niederösterreich;18582884;2926673;15656211
2021-11-19T09:30:00+01:00;4;Oberösterreich;17426088;1563508;15862580
2021-11-19T09:30:00+01:00;5;Salzburg;7582923;1064633;6518290
2021-11-19T09:30:00+01:00;6;Steiermark;14719491;1803428;12916063
2021-11-19T09:30:00+01:00;7;Tirol;6682343;1435393;5246950
2021-11-19T09:30:00+01:00;8;Vorarlberg;5406706;344816;5061890
2021-11-19T09:30:00+01:00;9;Wien;26917403;19835122;7082281
2021-11-19T09:30:00+01:00;10;Österreich;105877454;29955254;75922200
2021-11-20T09:30:00+01:00;1;Burgenland;3368444;446218;2922226
2021-11-20T09:30:00+01:00;2;Kärnten;5210162;549019;4661143
2021-11-20T09:30:00+01:00;3;Niederösterreich;18619564;2947667;15671897
2021-11-20T09:30:00+01:00;4;Oberösterreich;17474702;1607894;15866808
2021-11-20T09:30:00+01:00;5;Salzburg;7618557;1082697;6535860
2021-11-20T09:30:00+01:00;6;Steiermark;14743558;1813596;12929962
2021-11-20T09:30:00+01:00;7;Tirol;6696195;1446151;5250044
2021-11-20T09:30:00+01:00;8;Vorarlberg;5412739;347284;5065455
2021-11-20T09:30:00+01:00;9;Wien;27164080;20078918;7085162
2021-11-20T09:30:00+01:00;10;Österreich;106308001;30319444;75988557
2021-11-21T09:30:00+01:00;1;Burgenland;3378869;454385;2924484
2021-11-21T09:30:00+01:00;2;Kärnten;5224487;558178;4666309
2021-11-21T09:30:00+01:00;3;Niederösterreich;18647984;2967694;15680290
2021-11-21T09:30:00+01:00;4;Oberösterreich;17527606;1648892;15878714
2021-11-21T09:30:00+01:00;5;Salzburg;7647080;1100186;6546894
2021-11-21T09:30:00+01:00;6;Steiermark;14783583;1842824;12940759
2021-11-21T09:30:00+01:00;7;Tirol;6709923;1457335;5252588
2021-11-21T09:30:00+01:00;8;Vorarlberg;5417022;349920;5067102
2021-11-21T09:30:00+01:00;9;Wien;27495650;20407536;7088114
2021-11-21T09:30:00+01:00;10;Österreich;106832204;30786950;76045254
2021-11-22T09:30:00+01:00;1;Burgenland;3383075;456194;2926881
2021-11-22T09:30:00+01:00;2;Kärnten;5230627;564318;4666309
2021-11-22T09:30:00+01:00;3;Niederösterreich;18680927;2988827;15692100
2021-11-22T09:30:00+01:00;4;Oberösterreich;17580859;1689383;15891476
2021-11-22T09:30:00+01:00;5;Salzburg;7679104;1118070;6561034
2021-11-22T09:30:00+01:00;6;Steiermark;14808691;1867509;12941182
2021-11-22T09:30:00+01:00;7;Tirol;6729635;1471763;5257872
2021-11-22T09:30:00+01:00;8;Vorarlberg;5421735;352085;5069650
2021-11-22T09:30:00+01:00;9;Wien;27672498;20580639;7091859
2021-11-22T09:30:00+01:00;10;Österreich;107187151;31088788;76098363
2021-11-23T09:30:00+01:00;1;Burgenland;3388215;456960;2931255
2021-11-23T09:30:00+01:00;2;Kärnten;5237058;570749;4666309
2021-11-23T09:30:00+01:00;3;Niederösterreich;18718043;3007858;15710185
2021-11-23T09:30:00+01:00;4;Oberösterreich;17641473;1732044;15909429
2021-11-23T09:30:00+01:00;5;Salzburg;7703816;1128881;6574935
2021-11-23T09:30:00+01:00;6;Steiermark;14878418;1917836;12960582
2021-11-23T09:30:00+01:00;7;Tirol;6748791;1486575;5262216
2021-11-23T09:30:00+01:00;8;Vorarlberg;5429380;354664;5074716
2021-11-23T09:30:00+01:00;9;Wien;27870912;20776006;7094906
2021-11-23T09:30:00+01:00;10;Österreich;107616106;31431573;76184533
2021-11-24T09:30:00+01:00;1;Burgenland;3405359;470953;2934406
2021-11-24T09:30:00+01:00;2;Kärnten;5251291;580980;4670311
2021-11-24T09:30:00+01:00;3;Niederösterreich;18758223;3026764;15731459
2021-11-24T09:30:00+01:00;4;Oberösterreich;17694875;1768981;15925894
2021-11-24T09:30:00+01:00;5;Salzburg;7747076;1151996;6595080
2021-11-24T09:30:00+01:00;6;Steiermark;14942558;1927051;13015507
2021-11-24T09:30:00+01:00;7;Tirol;6762679;1496865;5265814
2021-11-24T09:30:00+01:00;8;Vorarlberg;5436478;357443;5079035
2021-11-24T09:30:00+01:00;9;Wien;27985635;20888374;7097261
2021-11-24T09:30:00+01:00;10;Österreich;107984174;31669407;76314767
2021-11-25T09:30:00+01:00;1;Burgenland;3415047;479156;2935891
2021-11-25T09:30:00+01:00;2;Kärnten;5303658;603564;4700094
2021-11-25T09:30:00+01:00;3;Niederösterreich;18790372;3046166;15744206
2021-11-25T09:30:00+01:00;4;Oberösterreich;17772313;1817833;15954480
2021-11-25T09:30:00+01:00;5;Salzburg;7786780;1174265;6612515
2021-11-25T09:30:00+01:00;6;Steiermark;14991127;1964096;13027031
2021-11-25T09:30:00+01:00;7;Tirol;6793680;1509317;5284363
2021-11-25T09:30:00+01:00;8;Vorarlberg;5443475;360674;5082801
2021-11-25T09:30:00+01:00;9;Wien;28307376;21207710;7099666
2021-11-25T09:30:00+01:00;10;Österreich;108603828;32162781;76441047
2021-11-26T09:30:00+01:00;1;Burgenland;3421046;481200;2939846
2021-11-26T09:30:00+01:00;2;Kärnten;5312800;612706;4700094
2021-11-26T09:30:00+01:00;3;Niederösterreich;18818024;3063636;15754388
2021-11-26T09:30:00+01:00;4;Oberösterreich;17822279;1852215;15970064
2021-11-26T09:30:00+01:00;5;Salzburg;7818403;1190842;6627561
2021-11-26T09:30:00+01:00;6;Steiermark;15065009;2027953;13037056
2021-11-26T09:30:00+01:00;7;Tirol;6810151;1522479;5287672
2021-11-26T09:30:00+01:00;8;Vorarlberg;5449988;363588;5086400
2021-11-26T09:30:00+01:00;9;Wien;28692304;21590396;7101908
2021-11-26T09:30:00+01:00;10;Österreich;109210004;32705015;76504989
2021-11-27T09:30:00+01:00;1;Burgenland;3434321;489833;2944488
2021-11-27T09:30:00+01:00;2;Kärnten;5332330;623414;4708916
2021-11-27T09:30:00+01:00;3;Niederösterreich;18844195;3081735;15762460
2021-11-27T09:30:00+01:00;4;Oberösterreich;17869565;1891731;15977834
2021-11-27T09:30:00+01:00;5;Salzburg;7842248;1203800;6638448
2021-11-27T09:30:00+01:00;6;Steiermark;15094549;2048753;13045796
2021-11-27T09:30:00+01:00;7;Tirol;6821372;1531315;5290057
2021-11-27T09:30:00+01:00;8;Vorarlberg;5455539;366210;5089329
2021-11-27T09:30:00+01:00;9;Wien;28862813;21759045;7103768
2021-11-27T09:30:00+01:00;10;Österreich;109556932;32995836;76561096
2021-11-28T09:30:00+01:00;1;Burgenland;3441444;496063;2945381
2021-11-28T09:30:00+01:00;2;Kärnten;5337043;628127;4708916
2021-11-28T09:30:00+01:00;3;Niederösterreich;18864964;3098061;15766903
2021-11-28T09:30:00+01:00;4;Oberösterreich;17910417;1929475;15980942
2021-11-28T09:30:00+01:00;5;Salzburg;7865022;1217968;6647054
2021-11-28T09:30:00+01:00;6;Steiermark;15132973;2078556;13054417
2021-11-28T09:30:00+01:00;7;Tirol;6830761;1539037;5291724
2021-11-28T09:30:00+01:00;8;Vorarlberg;5460154;369423;5090731
2021-11-28T09:30:00+01:00;9;Wien;28982367;21877141;7105226
2021-11-28T09:30:00+01:00;10;Österreich;109825145;33233851;76591294
2021-11-29T09:30:00+01:00;1;Burgenland;3445188;498866;2946322
2021-11-29T09:30:00+01:00;2;Kärnten;5343729;634439;4709290
2021-11-29T09:30:00+01:00;3;Niederösterreich;18888889;3113540;15775349
2021-11-29T09:30:00+01:00;4;Oberösterreich;17956136;1964119;15992017
2021-11-29T09:30:00+01:00;5;Salzburg;7887885;1230696;6657189
2021-11-29T09:30:00+01:00;6;Steiermark;15139705;2082015;13057690
2021-11-29T09:30:00+01:00;7;Tirol;6850109;1554119;5295990
2021-11-29T09:30:00+01:00;8;Vorarlberg;5465238;371900;5093338
2021-11-29T09:30:00+01:00;9;Wien;29133800;22026010;7107790
2021-11-29T09:30:00+01:00;10;Österreich;110110679;33475704;76634975
2021-11-30T09:30:00+01:00;1;Burgenland;3454981;504989;2949992
2021-11-30T09:30:00+01:00;2;Kärnten;5362424;648153;4714271
2021-11-30T09:30:00+01:00;3;Niederösterreich;18920746;3131035;15789711
2021-11-30T09:30:00+01:00;4;Oberösterreich;18006009;2009647;15996362
2021-11-30T09:30:00+01:00;5;Salzburg;7914357;1235982;6678375
2021-11-30T09:30:00+01:00;6;Steiermark;15193989;2120115;13073874
2021-11-30T09:30:00+01:00;7;Tirol;6864772;1565144;5299628
2021-11-30T09:30:00+01:00;8;Vorarlberg;5471923;374263;5097660
2021-11-30T09:30:00+01:00;9;Wien;29390581;22280610;7109971
2021-11-30T09:30:00+01:00;10;Österreich;110579782;33869938;76709844
2021-12-01T09:30:00+01:00;1;Burgenland;3463282;510603;2952679
2021-12-01T09:30:00+01:00;2;Kärnten;5366660;652007;4714653
2021-12-01T09:30:00+01:00;3;Niederösterreich;18945508;3147346;15798162
2021-12-01T09:30:00+01:00;4;Oberösterreich;18053117;2054355;15998762
2021-12-01T09:30:00+01:00;5;Salzburg;7953685;1260226;6693459
2021-12-01T09:30:00+01:00;6;Steiermark;15253609;2128176;13125433
2021-12-01T09:30:00+01:00;7;Tirol;6891703;1574616;5317087
2021-12-01T09:30:00+01:00;8;Vorarlberg;5478993;377636;5101357
2021-12-01T09:30:00+01:00;9;Wien;29664779;22552759;7112020
2021-12-01T09:30:00+01:00;10;Österreich;111071336;34257724;76813612
2021-12-02T09:30:00+01:00;1;Burgenland;3470103;515270;2954833
2021-12-02T09:30:00+01:00;2;Kärnten;5379269;664616;4714653
2021-12-02T09:30:00+01:00;3;Niederösterreich;18981307;3163703;15817604
2021-12-02T09:30:00+01:00;4;Oberösterreich;18136522;2110530;16025992
2021-12-02T09:30:00+01:00;5;Salzburg;7983500;1279387;6704113
2021-12-02T09:30:00+01:00;6;Steiermark;15275721;2139876;13135845
2021-12-02T09:30:00+01:00;7;Tirol;6901229;1580265;5320964
2021-12-02T09:30:00+01:00;8;Vorarlberg;5485620;380408;5105212
2021-12-02T09:30:00+01:00;9;Wien;29924374;22809895;7114479
2021-12-02T09:30:00+01:00;10;Österreich;111537645;34643950;76893695
2021-12-03T09:30:00+01:00;1;Burgenland;3475446;517397;2958049
2021-12-03T09:30:00+01:00;2;Kärnten;5407987;670539;4737448
2021-12-03T09:30:00+01:00;3;Niederösterreich;19006895;3180186;15826709
2021-12-03T09:30:00+01:00;4;Oberösterreich;18166584;2131485;16035099
2021-12-03T09:30:00+01:00;5;Salzburg;8008703;1294090;6714613
2021-12-03T09:30:00+01:00;6;Steiermark;15332383;2187747;13144636
2021-12-03T09:30:00+01:00;7;Tirol;6914023;1590356;5323667
2021-12-03T09:30:00+01:00;8;Vorarlberg;5491141;382704;5108437
2021-12-03T09:30:00+01:00;9;Wien;30134804;23018122;7116682
2021-12-03T09:30:00+01:00;10;Österreich;111937966;34972626;76965340
2021-12-04T09:30:00+01:00;1;Burgenland;3484093;522598;2961495
2021-12-04T09:30:00+01:00;2;Kärnten;5423758;678757;4745001
2021-12-04T09:30:00+01:00;3;Niederösterreich;19029824;3196741;15833083
2021-12-04T09:30:00+01:00;4;Oberösterreich;18210940;2169740;16041200
2021-12-04T09:30:00+01:00;5;Salzburg;8026467;1304462;6722005
2021-12-04T09:30:00+01:00;6;Steiermark;15366648;2213674;13152974
2021-12-04T09:30:00+01:00;7;Tirol;6924999;1599238;5325761
2021-12-04T09:30:00+01:00;8;Vorarlberg;5494331;385371;5108960
2021-12-04T09:30:00+01:00;9;Wien;30273352;23154767;7118585
2021-12-04T09:30:00+01:00;10;Österreich;112234412;35225348;77009064
2021-12-05T09:30:00+01:00;1;Burgenland;3493316;531247;2962069
2021-12-05T09:30:00+01:00;2;Kärnten;5427484;682483;4745001
2021-12-05T09:30:00+01:00;3;Niederösterreich;19050292;3212356;15837936
2021-12-05T09:30:00+01:00;4;Oberösterreich;18241618;2197496;16044122
2021-12-05T09:30:00+01:00;5;Salzburg;8046090;1317227;6728863
2021-12-05T09:30:00+01:00;6;Steiermark;15408974;2248200;13160774
2021-12-05T09:30:00+01:00;7;Tirol;6932994;1605683;5327311
2021-12-05T09:30:00+01:00;8;Vorarlberg;5496221;387261;5108960
2021-12-05T09:30:00+01:00;9;Wien;30429845;23309639;7120206
2021-12-05T09:30:00+01:00;10;Österreich;112526834;35491592;77035242
2021-12-06T09:30:00+01:00;1;Burgenland;3496383;533166;2963217
2021-12-06T09:30:00+01:00;2;Kärnten;5431708;686329;4745379
2021-12-06T09:30:00+01:00;3;Niederösterreich;19071802;3226852;15844950
2021-12-06T09:30:00+01:00;4;Oberösterreich;18287239;2234128;16053111
2021-12-06T09:30:00+01:00;5;Salzburg;8067048;1329467;6737581
2021-12-06T09:30:00+01:00;6;Steiermark;15462992;2297690;13165302
2021-12-06T09:30:00+01:00;7;Tirol;6947627;1616296;5331331
2021-12-06T09:30:00+01:00;8;Vorarlberg;5573887;389092;5184795
2021-12-06T09:30:00+01:00;9;Wien;30568695;23445900;7122795
2021-12-06T09:30:00+01:00;10;Österreich;112907381;35758920;77148461
2021-12-07T09:30:00+01:00;1;Burgenland;3505327;539195;2966132
2021-12-07T09:30:00+01:00;2;Kärnten;5446122;698286;4747836
2021-12-07T09:30:00+01:00;3;Niederösterreich;19099087;3242605;15856482
2021-12-07T09:30:00+01:00;4;Oberösterreich;18335911;2255735;16080176
2021-12-07T09:30:00+01:00;5;Salzburg;8088241;1332620;6755621
2021-12-07T09:30:00+01:00;6;Steiermark;15488613;2308981;13179632
2021-12-07T09:30:00+01:00;7;Tirol;6971974;1623651;5348323
2021-12-07T09:30:00+01:00;8;Vorarlberg;5510265;392005;5118260
2021-12-07T09:30:00+01:00;9;Wien;30849755;23724542;7125213
2021-12-07T09:30:00+01:00;10;Österreich;113295295;36117620;77177675
2021-12-08T09:30:00+01:00;1;Burgenland;3507813;540337;2967476
2021-12-08T09:30:00+01:00;2;Kärnten;5454680;700286;4754394
2021-12-08T09:30:00+01:00;3;Niederösterreich;19119951;3258134;15861817
2021-12-08T09:30:00+01:00;4;Oberösterreich;18385749;2297530;16088219
2021-12-08T09:30:00+01:00;5;Salzburg;8123981;1355990;6767991
2021-12-08T09:30:00+01:00;6;Steiermark;15542106;2312776;13229330
2021-12-08T09:30:00+01:00;7;Tirol;6980529;1630277;5350252
2021-12-08T09:30:00+01:00;8;Vorarlberg;5515540;394802;5120738
2021-12-08T09:30:00+01:00;9;Wien;31060627;23933403;7127224
2021-12-08T09:30:00+01:00;10;Österreich;113690976;36423535;77267441
2021-12-09T09:30:00+01:00;1;Burgenland;3517032;548601;2968431
2021-12-09T09:30:00+01:00;2;Kärnten;5463268;708874;4754394
2021-12-09T09:30:00+01:00;3;Niederösterreich;19149378;3274145;15875233
2021-12-09T09:30:00+01:00;4;Oberösterreich;18434162;2326477;16107685
2021-12-09T09:30:00+01:00;5;Salzburg;8144834;1368419;6776415
2021-12-09T09:30:00+01:00;6;Steiermark;15556547;2320195;13236352
2021-12-09T09:30:00+01:00;7;Tirol;6991901;1638633;5353268
2021-12-09T09:30:00+01:00;8;Vorarlberg;5518905;396394;5122511
2021-12-09T09:30:00+01:00;9;Wien;31216830;24087225;7129605
2021-12-09T09:30:00+01:00;10;Österreich;113992857;36668963;77323894
2021-12-10T09:30:00+01:00;1;Burgenland;3521444;551168;2970276
2021-12-10T09:30:00+01:00;2;Kärnten;5470876;716482;4754394
2021-12-10T09:30:00+01:00;3;Niederösterreich;19172302;3290415;15881887
2021-12-10T09:30:00+01:00;4;Oberösterreich;18473358;2356944;16116414
2021-12-10T09:30:00+01:00;5;Salzburg;8154218;1373736;6780482
2021-12-10T09:30:00+01:00;6;Steiermark;15607688;2362884;13244804
2021-12-10T09:30:00+01:00;7;Tirol;7000539;1644825;5355714
2021-12-10T09:30:00+01:00;8;Vorarlberg;5523911;398459;5125452
2021-12-10T09:30:00+01:00;9;Wien;31479550;24347506;7132044
2021-12-10T09:30:00+01:00;10;Österreich;114403886;37042419;77361467
2021-12-11T09:30:00+01:00;1;Burgenland;3525190;552078;2973112
2021-12-11T09:30:00+01:00;2;Kärnten;5474626;720232;4754394
2021-12-11T09:30:00+01:00;3;Niederösterreich;19195174;3306704;15888470
2021-12-11T09:30:00+01:00;4;Oberösterreich;18486972;2370395;16116577
2021-12-11T09:30:00+01:00;5;Salzburg;8175559;1386360;6789199
2021-12-11T09:30:00+01:00;6;Steiermark;15619194;2367295;13251899
2021-12-11T09:30:00+01:00;7;Tirol;7007791;1650439;5357352
2021-12-11T09:30:00+01:00;8;Vorarlberg;5528412;400738;5127674
2021-12-11T09:30:00+01:00;9;Wien;31655122;24521166;7133956
2021-12-11T09:30:00+01:00;10;Österreich;114668040;37275407;77392633
2021-12-12T09:30:00+01:00;1;Burgenland;3534059;560561;2973498
2021-12-12T09:30:00+01:00;2;Kärnten;5479079;724685;4754394
2021-12-12T09:30:00+01:00;3;Niederösterreich;19215046;3323206;15891840
2021-12-12T09:30:00+01:00;4;Oberösterreich;18522469;2398331;16124138
2021-12-12T09:30:00+01:00;5;Salzburg;8193678;1398476;6795202
2021-12-12T09:30:00+01:00;6;Steiermark;15679838;2421043;13258795
2021-12-12T09:30:00+01:00;7;Tirol;7014329;1655589;5358740
2021-12-12T09:30:00+01:00;8;Vorarlberg;5530511;401714;5128797
2021-12-12T09:30:00+01:00;9;Wien;31787491;24651904;7135587
2021-12-12T09:30:00+01:00;10;Österreich;114956500;37535509;77420991
2021-12-13T09:30:00+01:00;1;Burgenland;3538498;563934;2974564
2021-12-13T09:30:00+01:00;2;Kärnten;5483601;729207;4754394
2021-12-13T09:30:00+01:00;3;Niederösterreich;19237506;3339435;15898071
2021-12-13T09:30:00+01:00;4;Oberösterreich;18556465;2424444;16132021
2021-12-13T09:30:00+01:00;5;Salzburg;8212971;1409172;6803799
2021-12-13T09:30:00+01:00;6;Steiermark;15685536;2421999;13263537
2021-12-13T09:30:00+01:00;7;Tirol;7025875;1663232;5362643
2021-12-13T09:30:00+01:00;8;Vorarlberg;5534592;403633;5130959
2021-12-13T09:30:00+01:00;9;Wien;31942979;24804805;7138174
2021-12-13T09:30:00+01:00;10;Österreich;115218023;37759861;77458162
2021-12-14T09:30:00+01:00;1;Burgenland;3546228;568924;2977304
2021-12-14T09:30:00+01:00;2;Kärnten;5494733;740339;4754394
2021-12-14T09:30:00+01:00;3;Niederösterreich;19264128;3355982;15908146
2021-12-14T09:30:00+01:00;4;Oberösterreich;18612718;2461984;16150734
2021-12-14T09:30:00+01:00;5;Salzburg;8236133;1415501;6820632
2021-12-14T09:30:00+01:00;6;Steiermark;15712109;2434728;13277381
2021-12-14T09:30:00+01:00;7;Tirol;7036865;1671181;5365684
2021-12-14T09:30:00+01:00;8;Vorarlberg;5540022;405323;5134699
2021-12-14T09:30:00+01:00;9;Wien;32235764;25094665;7141099
2021-12-14T09:30:00+01:00;10;Österreich;115678700;38148627;77530073
2021-12-15T09:30:00+01:00;1;Burgenland;3549180;570448;2978732
2021-12-15T09:30:00+01:00;2;Kärnten;5499562;741823;4757739
2021-12-15T09:30:00+01:00;3;Niederösterreich;19295194;3372697;15922497
2021-12-15T09:30:00+01:00;4;Oberösterreich;18657088;2504722;16152366
2021-12-15T09:30:00+01:00;5;Salzburg;8269970;1436417;6833553
2021-12-15T09:30:00+01:00;6;Steiermark;15793357;2465651;13327706
2021-12-15T09:30:00+01:00;7;Tirol;7061731;1681060;5380671
2021-12-15T09:30:00+01:00;8;Vorarlberg;5544582;406927;5137655
2021-12-15T09:30:00+01:00;9;Wien;32474569;25331465;7143104
2021-12-15T09:30:00+01:00;10;Österreich;116145233;38511210;77634023
2021-12-16T09:30:00+01:00;1;Burgenland;3557479;576961;2980518
2021-12-16T09:30:00+01:00;2;Kärnten;5511744;752736;4759008
2021-12-16T09:30:00+01:00;3;Niederösterreich;19319517;3389903;15929614
2021-12-16T09:30:00+01:00;4;Oberösterreich;18688082;2515484;16172598
2021-12-16T09:30:00+01:00;5;Salzburg;8292267;1450105;6842162
2021-12-16T09:30:00+01:00;6;Steiermark;15836335;2499438;13336897
2021-12-16T09:30:00+01:00;7;Tirol;7073051;1689498;5383553
2021-12-16T09:30:00+01:00;8;Vorarlberg;5548802;408432;5140370
2021-12-16T09:30:00+01:00;9;Wien;32728657;25583415;7145242
2021-12-16T09:30:00+01:00;10;Österreich;116555934;38865972;77689962
2021-12-17T09:30:00+01:00;1;Burgenland;3565582;583840;2981742
2021-12-17T09:30:00+01:00;2;Kärnten;5521082;758529;4762553
2021-12-17T09:30:00+01:00;3;Niederösterreich;19343526;3407150;15936376
2021-12-17T09:30:00+01:00;4;Oberösterreich;18739681;2560483;16179198
2021-12-17T09:30:00+01:00;5;Salzburg;8315724;1463988;6851736
2021-12-17T09:30:00+01:00;6;Steiermark;15860882;2515478;13345404
2021-12-17T09:30:00+01:00;7;Tirol;7082182;1695874;5386308
2021-12-17T09:30:00+01:00;8;Vorarlberg;5552829;409644;5143185
2021-12-17T09:30:00+01:00;9;Wien;33003270;25855808;7147462
2021-12-17T09:30:00+01:00;10;Österreich;116984758;39250794;77733964
2021-12-18T09:30:00+01:00;1;Burgenland;3569926;585212;2984714
2021-12-18T09:30:00+01:00;2;Kärnten;5527765;765212;4762553
2021-12-18T09:30:00+01:00;3;Niederösterreich;19369156;3425596;15943560
2021-12-18T09:30:00+01:00;4;Oberösterreich;18771228;2586151;16185077
2021-12-18T09:30:00+01:00;5;Salzburg;8333927;1474200;6859727
2021-12-18T09:30:00+01:00;6;Steiermark;15903268;2549310;13353958
2021-12-18T09:30:00+01:00;7;Tirol;7090144;1701405;5388739
2021-12-18T09:30:00+01:00;8;Vorarlberg;5556552;410884;5145668
2021-12-18T09:30:00+01:00;9;Wien;33195661;26046068;7149593
2021-12-18T09:30:00+01:00;10;Österreich;117317627;39544038;77773589
2021-12-19T09:30:00+01:00;1;Burgenland;3580261;594816;2985445
2021-12-19T09:30:00+01:00;2;Kärnten;5532893;770340;4762553
2021-12-19T09:30:00+01:00;3;Niederösterreich;19392246;3444320;15947926
2021-12-19T09:30:00+01:00;4;Oberösterreich;18808534;2620242;16188292
2021-12-19T09:30:00+01:00;5;Salzburg;8354335;1487358;6866977
2021-12-19T09:30:00+01:00;6;Steiermark;15917369;2555989;13361380
2021-12-19T09:30:00+01:00;7;Tirol;7098444;1707319;5391125
2021-12-19T09:30:00+01:00;8;Vorarlberg;5559091;412123;5146968
2021-12-19T09:30:00+01:00;9;Wien;33337308;26185778;7151530
2021-12-19T09:30:00+01:00;10;Österreich;117580481;39778285;77802196
2021-12-20T09:30:00+01:00;1;Burgenland;3585991;599570;2986421
2021-12-20T09:30:00+01:00;2;Kärnten;5538254;775701;4762553
2021-12-20T09:30:00+01:00;3;Niederösterreich;19416290;3462858;15953432
2021-12-20T09:30:00+01:00;4;Oberösterreich;18850737;2655134;16195603
2021-12-20T09:30:00+01:00;5;Salzburg;8371934;1496985;6874949
2021-12-20T09:30:00+01:00;6;Steiermark;15925780;2559667;13366113
2021-12-20T09:30:00+01:00;7;Tirol;7110246;1715418;5394828
2021-12-20T09:30:00+01:00;8;Vorarlberg;5562240;413242;5148998
2021-12-20T09:30:00+01:00;9;Wien;33471137;26316880;7154257
2021-12-20T09:30:00+01:00;10;Österreich;117832609;39995455;77837154
2021-12-21T09:30:00+01:00;1;Burgenland;3591071;602489;2988582
2021-12-21T09:30:00+01:00;2;Kärnten;5554024;785803;4768221
2021-12-21T09:30:00+01:00;3;Niederösterreich;19445576;3482388;15963188
2021-12-21T09:30:00+01:00;4;Oberösterreich;18889043;2681244;16207799
2021-12-21T09:30:00+01:00;5;Salzburg;8391625;1500157;6891468
2021-12-21T09:30:00+01:00;6;Steiermark;15996538;2616963;13379575
2021-12-21T09:30:00+01:00;7;Tirol;7122246;1724569;5397677
2021-12-21T09:30:00+01:00;8;Vorarlberg;5567280;414764;5152516
2021-12-21T09:30:00+01:00;9;Wien;33592180;26434753;7157427
2021-12-21T09:30:00+01:00;10;Österreich;118149583;40243130;77906453
2021-12-22T09:30:00+01:00;1;Burgenland;3592439;603215;2989224
2021-12-22T09:30:00+01:00;2;Kärnten;5555173;786952;4768221
2021-12-22T09:30:00+01:00;3;Niederösterreich;19476984;3500803;15976181
2021-12-22T09:30:00+01:00;4;Oberösterreich;18920769;2704764;16216005
2021-12-22T09:30:00+01:00;5;Salzburg;8429623;1525203;6904420
2021-12-22T09:30:00+01:00;6;Steiermark;16054647;2625593;13429054
2021-12-22T09:30:00+01:00;7;Tirol;7158034;1744514;5413520
2021-12-22T09:30:00+01:00;8;Vorarlberg;5571622;416222;5155400
2021-12-22T09:30:00+01:00;9;Wien;33928750;26768948;7159802
2021-12-22T09:30:00+01:00;10;Österreich;118688041;40676214;78011827
2021-12-23T09:30:00+01:00;1;Burgenland;3602815;611550;2991265
2021-12-23T09:30:00+01:00;2;Kärnten;5572488;797097;4775391
2021-12-23T09:30:00+01:00;3;Niederösterreich;19503642;3520825;15982817
2021-12-23T09:30:00+01:00;4;Oberösterreich;18978581;2744734;16233847
2021-12-23T09:30:00+01:00;5;Salzburg;8453267;1540031;6913236
2021-12-23T09:30:00+01:00;6;Steiermark;16084115;2646587;13437528
2021-12-23T09:30:00+01:00;7;Tirol;7172605;1756420;5416185
2021-12-23T09:30:00+01:00;8;Vorarlberg;5575486;417433;5158053
2021-12-23T09:30:00+01:00;9;Wien;34083244;26921024;7162220
2021-12-23T09:30:00+01:00;10;Österreich;119026243;40955701;78070542
2021-12-24T09:30:00+01:00;1;Burgenland;3609263;616535;2992728
2021-12-24T09:30:00+01:00;2;Kärnten;5578429;803038;4775391
2021-12-24T09:30:00+01:00;3;Niederösterreich;19533040;3540855;15992185
2021-12-24T09:30:00+01:00;4;Oberösterreich;19020723;2780129;16240594
2021-12-24T09:30:00+01:00;5;Salzburg;8478261;1554714;6923547
2021-12-24T09:30:00+01:00;6;Steiermark;16119741;2671656;13448085
2021-12-24T09:30:00+01:00;7;Tirol;7191194;1772553;5418641
2021-12-24T09:30:00+01:00;8;Vorarlberg;5579845;418724;5161121
2021-12-24T09:30:00+01:00;9;Wien;34423770;27259186;7164584
2021-12-24T09:30:00+01:00;10;Österreich;119534266;41417390;78116876
2021-12-25T09:30:00+01:00;1;Burgenland;3618320;620612;2997708
2021-12-25T09:30:00+01:00;2;Kärnten;5585219;809828;4775391
2021-12-25T09:30:00+01:00;3;Niederösterreich;19560282;3561088;15999194
2021-12-25T09:30:00+01:00;4;Oberösterreich;19055219;2810984;16244235
2021-12-25T09:30:00+01:00;5;Salzburg;8507915;1572279;6935636
2021-12-25T09:30:00+01:00;6;Steiermark;16140249;2686035;13454214
2021-12-25T09:30:00+01:00;7;Tirol;7201703;1781045;5420658
2021-12-25T09:30:00+01:00;8;Vorarlberg;5582017;419346;5162671
2021-12-25T09:30:00+01:00;9;Wien;34672854;27505964;7166890
2021-12-25T09:30:00+01:00;10;Österreich;119923778;41767181;78156597
2021-12-26T09:30:00+01:00;1;Burgenland;3630911;632164;2998747
2021-12-26T09:30:00+01:00;2;Kärnten;5592981;813620;4779361
2021-12-26T09:30:00+01:00;3;Niederösterreich;19578723;3577137;16001586
2021-12-26T09:30:00+01:00;4;Oberösterreich;19086057;2838536;16247521
2021-12-26T09:30:00+01:00;5;Salzburg;8527942;1584918;6943024
2021-12-26T09:30:00+01:00;6;Steiermark;16221822;2763290;13458532
2021-12-26T09:30:00+01:00;7;Tirol;7215118;1792253;5422865
2021-12-26T09:30:00+01:00;8;Vorarlberg;5584407;420184;5164223
2021-12-26T09:30:00+01:00;9;Wien;34776326;27607188;7169138
2021-12-26T09:30:00+01:00;10;Österreich;120214287;42029290;78184997
2021-12-27T09:30:00+01:00;1;Burgenland;3636947;637080;2999867
2021-12-27T09:30:00+01:00;2;Kärnten;5594634;815273;4779361
2021-12-27T09:30:00+01:00;3;Niederösterreich;19599528;3594279;16005249
2021-12-27T09:30:00+01:00;4;Oberösterreich;19126334;2871485;16254849
2021-12-27T09:30:00+01:00;5;Salzburg;8529102;1585923;6943179
2021-12-27T09:30:00+01:00;6;Steiermark;16242302;2778207;13464095
2021-12-27T09:30:00+01:00;7;Tirol;7229276;1802878;5426398
2021-12-27T09:30:00+01:00;8;Vorarlberg;5587155;420846;5166309
2021-12-27T09:30:00+01:00;9;Wien;34862341;27690339;7172002
2021-12-27T09:30:00+01:00;10;Österreich;120407619;42196310;78211309
2021-12-28T09:30:00+01:00;1;Burgenland;3641157;638839;3002318
2021-12-28T09:30:00+01:00;2;Kärnten;5609938;823682;4786256
2021-12-28T09:30:00+01:00;3;Niederösterreich;21500748;5211614;16289134
2021-12-28T09:30:00+01:00;4;Oberösterreich;19179068;2905276;16273792
2021-12-28T09:30:00+01:00;5;Salzburg;8566728;1597079;6969649
2021-12-28T09:30:00+01:00;6;Steiermark;16282634;2806871;13475763
2021-12-28T09:30:00+01:00;7;Tirol;7247572;1818352;5429220
2021-12-28T09:30:00+01:00;8;Vorarlberg;5591609;422218;5169391
2021-12-28T09:30:00+01:00;9;Wien;34984446;27810217;7174229
2021-12-28T09:30:00+01:00;10;Österreich;122603900;44034148;78569752
2021-12-29T09:30:00+01:00;1;Burgenland;3648689;644344;3004345
2021-12-29T09:30:00+01:00;2;Kärnten;5620459;834030;4786429
2021-12-29T09:30:00+01:00;3;Niederösterreich;21524035;5227547;16296488
2021-12-29T09:30:00+01:00;4;Oberösterreich;19211027;2931860;16279167
2021-12-29T09:30:00+01:00;5;Salzburg;8596373;1614135;6982238
2021-12-29T09:30:00+01:00;6;Steiermark;16360370;2836821;13523549
2021-12-29T09:30:00+01:00;7;Tirol;7262098;1830405;5431693
2021-12-29T09:30:00+01:00;8;Vorarlberg;5598236;426294;5171942
2021-12-29T09:30:00+01:00;9;Wien;35099844;27924063;7175781
2021-12-29T09:30:00+01:00;10;Österreich;122921131;44269499;78651632
2021-12-30T09:30:00+01:00;1;Burgenland;3654807;649317;3005490
2021-12-30T09:30:00+01:00;2;Kärnten;5625840;839411;4786429
2021-12-30T09:30:00+01:00;3;Niederösterreich;21544941;5244231;16300710
2021-12-30T09:30:00+01:00;4;Oberösterreich;19250945;2954604;16296341
2021-12-30T09:30:00+01:00;5;Salzburg;8616553;1625645;6990908
2021-12-30T09:30:00+01:00;6;Steiermark;16386040;2854567;13531473
2021-12-30T09:30:00+01:00;7;Tirol;7290310;1844075;5446235
2021-12-30T09:30:00+01:00;8;Vorarlberg;5604619;430224;5174395
2021-12-30T09:30:00+01:00;9;Wien;35252793;28074025;7178768
2021-12-30T09:30:00+01:00;10;Österreich;123226848;44516099;78710749
2021-12-31T09:30:00+01:00;1;Burgenland;3661658;655034;3006624
2021-12-31T09:30:00+01:00;2;Kärnten;5635480;847265;4788215
2021-12-31T09:30:00+01:00;3;Niederösterreich;21567571;5262168;16305403
2021-12-31T09:30:00+01:00;4;Oberösterreich;19294131;2992174;16301957
2021-12-31T09:30:00+01:00;5;Salzburg;8644644;1643773;7000871
2021-12-31T09:30:00+01:00;6;Steiermark;16420787;2880018;13540769
2021-12-31T09:30:00+01:00;7;Tirol;7313265;1864366;5448899
2021-12-31T09:30:00+01:00;8;Vorarlberg;5612950;435733;5177217
2021-12-31T09:30:00+01:00;9;Wien;35428723;28248063;7180660
2021-12-31T09:30:00+01:00;10;Österreich;123579209;44828594;78750615
2022-01-01T09:30:00+01:00;1;Burgenland;3669515;659538;3009977
2022-01-01T09:30:00+01:00;2;Kärnten;5642117;853902;4788215
2022-01-01T09:30:00+01:00;3;Niederösterreich;21587829;5278661;16309168
2022-01-01T09:30:00+01:00;4;Oberösterreich;19323197;3017435;16305762
2022-01-01T09:30:00+01:00;5;Salzburg;8674173;1660603;7013570
2022-01-01T09:30:00+01:00;6;Steiermark;16450921;2903984;13546937
2022-01-01T09:30:00+01:00;7;Tirol;7325190;1873871;5451319
2022-01-01T09:30:00+01:00;8;Vorarlberg;5617573;438264;5179309
2022-01-01T09:30:00+01:00;9;Wien;35617362;28434387;7182975
2022-01-01T09:30:00+01:00;10;Österreich;123907877;45120645;78787232
2022-01-02T09:30:00+01:00;1;Burgenland;3679860;669346;3010514
2022-01-02T09:30:00+01:00;2;Kärnten;5649888;859308;4790580
2022-01-02T09:30:00+01:00;3;Niederösterreich;21605533;5294875;16310658
2022-01-02T09:30:00+01:00;4;Oberösterreich;19348104;3040474;16307630
2022-01-02T09:30:00+01:00;5;Salzburg;8691706;1671520;7020186
2022-01-02T09:30:00+01:00;6;Steiermark;16474803;2924699;13550104
2022-01-02T09:30:00+01:00;7;Tirol;7340919;1887637;5453282
2022-01-02T09:30:00+01:00;8;Vorarlberg;5622433;441663;5180770
2022-01-02T09:30:00+01:00;9;Wien;35693180;28508505;7184675
2022-01-02T09:30:00+01:00;10;Österreich;124106426;45298027;78808399
2022-01-03T09:30:00+01:00;1;Burgenland;3685453;672941;3012512
2022-01-03T09:30:00+01:00;2;Kärnten;5651313;860733;4790580
2022-01-03T09:30:00+01:00;3;Niederösterreich;21626521;5311220;16315301
2022-01-03T09:30:00+01:00;4;Oberösterreich;19398527;3082571;16315956
2022-01-03T09:30:00+01:00;5;Salzburg;8693629;1673200;7020429
2022-01-03T09:30:00+01:00;6;Steiermark;16490529;2934243;13556286
2022-01-03T09:30:00+01:00;7;Tirol;7355563;1898339;5457224
2022-01-03T09:30:00+01:00;8;Vorarlberg;5629283;446217;5183066
2022-01-03T09:30:00+01:00;9;Wien;35773733;28585650;7188083
2022-01-03T09:30:00+01:00;10;Österreich;124304551;45465114;78839437
2022-01-04T09:30:00+01:00;1;Burgenland;3690211;675932;3014279
2022-01-04T09:30:00+01:00;2;Kärnten;5655826;862897;4792929
2022-01-04T09:30:00+01:00;3;Niederösterreich;21651517;5327610;16323907
2022-01-04T09:30:00+01:00;4;Oberösterreich;19437927;3113512;16324415
2022-01-04T09:30:00+01:00;5;Salzburg;8720005;1683811;7036194
2022-01-04T09:30:00+01:00;6;Steiermark;16557442;2956389;13601053
2022-01-04T09:30:00+01:00;7;Tirol;7384294;1918143;5466151
2022-01-04T09:30:00+01:00;8;Vorarlberg;5637147;450426;5186721
2022-01-04T09:30:00+01:00;9;Wien;35901914;28711483;7190431
2022-01-04T09:30:00+01:00;10;Österreich;124636283;45700203;78936080
2022-01-05T09:30:00+01:00;1;Burgenland;3699077;681936;3017141
2022-01-05T09:30:00+01:00;2;Kärnten;5668641;865893;4802748
2022-01-05T09:30:00+01:00;3;Niederösterreich;21681582;5345100;16336482
2022-01-05T09:30:00+01:00;4;Oberösterreich;19468989;3136897;16332092
2022-01-05T09:30:00+01:00;5;Salzburg;8756522;1705803;7050719
2022-01-05T09:30:00+01:00;6;Steiermark;16629275;2994994;13634281
2022-01-05T09:30:00+01:00;7;Tirol;7402715;1934069;5468646
2022-01-05T09:30:00+01:00;8;Vorarlberg;5834166;644425;5189741
2022-01-05T09:30:00+01:00;9;Wien;36065902;28873800;7192102
2022-01-05T09:30:00+01:00;10;Österreich;125206869;46182917;79023952
2022-01-06T09:30:00+01:00;1;Burgenland;3707296;688981;3018315
2022-01-06T09:30:00+01:00;2;Kärnten;5680753;878005;4802748
2022-01-06T09:30:00+01:00;3;Niederösterreich;21709076;5361848;16347228
2022-01-06T09:30:00+01:00;4;Oberösterreich;19501691;3161244;16340447
2022-01-06T09:30:00+01:00;5;Salzburg;8783507;1722972;7060535
2022-01-06T09:30:00+01:00;6;Steiermark;16656583;3012640;13643943
2022-01-06T09:30:00+01:00;7;Tirol;7425749;1954601;5471148
2022-01-06T09:30:00+01:00;8;Vorarlberg;5840284;648127;5192157
2022-01-06T09:30:00+01:00;9;Wien;36221450;29027245;7194205
2022-01-06T09:30:00+01:00;10;Österreich;125526389;46455663;79070726
2022-01-07T09:30:00+01:00;1;Burgenland;3710837;690744;3020093
2022-01-07T09:30:00+01:00;2;Kärnten;5693993;884736;4809257
2022-01-07T09:30:00+01:00;3;Niederösterreich;21729964;5378508;16351456
2022-01-07T09:30:00+01:00;4;Oberösterreich;19542148;3197283;16344865
2022-01-07T09:30:00+01:00;5;Salzburg;8808812;1738476;7070336
2022-01-07T09:30:00+01:00;6;Steiermark;16681736;3032397;13649339
2022-01-07T09:30:00+01:00;7;Tirol;7442812;1968698;5474114
2022-01-07T09:30:00+01:00;8;Vorarlberg;5846299;652412;5193887
2022-01-07T09:30:00+01:00;9;Wien;36400937;29203783;7197154
2022-01-07T09:30:00+01:00;10;Österreich;125857538;46747037;79110501
2022-01-08T09:30:00+01:00;1;Burgenland;3734483;702109;3032374
2022-01-08T09:30:00+01:00;2;Kärnten;5697921;886324;4811597
2022-01-08T09:30:00+01:00;3;Niederösterreich;21755896;5396495;16359401
2022-01-08T09:30:00+01:00;4;Oberösterreich;19573465;3222904;16350561
2022-01-08T09:30:00+01:00;5;Salzburg;8823087;1747975;7075112
2022-01-08T09:30:00+01:00;6;Steiermark;16718166;3057610;13660556
2022-01-08T09:30:00+01:00;7;Tirol;7469550;1992465;5477085
2022-01-08T09:30:00+01:00;8;Vorarlberg;5984837;787735;5197102
2022-01-08T09:30:00+01:00;9;Wien;36571842;29372362;7199480
2022-01-08T09:30:00+01:00;10;Österreich;126329247;47165979;79163268
2022-01-09T09:30:00+01:00;1;Burgenland;3737938;703975;3033963
2022-01-09T09:30:00+01:00;2;Kärnten;5708730;897133;4811597
2022-01-09T09:30:00+01:00;3;Niederösterreich;21779566;5415164;16364402
2022-01-09T09:30:00+01:00;4;Oberösterreich;19619835;3265181;16354654
2022-01-09T09:30:00+01:00;5;Salzburg;8860678;1772360;7088318
2022-01-09T09:30:00+01:00;6;Steiermark;16767489;3081512;13685977
2022-01-09T09:30:00+01:00;7;Tirol;7502589;2022742;5479847
2022-01-09T09:30:00+01:00;8;Vorarlberg;5996488;797515;5198973
2022-01-09T09:30:00+01:00;9;Wien;36802633;29600499;7202134
2022-01-09T09:30:00+01:00;10;Österreich;126775946;47556081;79219865
2022-01-10T09:30:00+01:00;1;Burgenland;3752540;715560;3036980
2022-01-10T09:30:00+01:00;2;Kärnten;5717150;905447;4811703
2022-01-10T09:30:00+01:00;3;Niederösterreich;21806638;5434002;16372636
2022-01-10T09:30:00+01:00;4;Oberösterreich;19673676;3308758;16364918
2022-01-10T09:30:00+01:00;5;Salzburg;8888007;1789060;7098947
2022-01-10T09:30:00+01:00;6;Steiermark;16808676;3115701;13692975
2022-01-10T09:30:00+01:00;7;Tirol;7519893;2035010;5484883
2022-01-10T09:30:00+01:00;8;Vorarlberg;6009167;807619;5201548
2022-01-10T09:30:00+01:00;9;Wien;37128571;29922398;7206173
2022-01-10T09:30:00+01:00;10;Österreich;127304318;48033555;79270763
2022-01-11T09:30:00+01:00;1;Burgenland;3771307;728257;3043050
2022-01-11T09:30:00+01:00;2;Kärnten;5732737;913712;4819025
2022-01-11T09:30:00+01:00;3;Niederösterreich;21839448;5453014;16386434
2022-01-11T09:30:00+01:00;4;Oberösterreich;19727822;3350761;16377061
2022-01-11T09:30:00+01:00;5;Salzburg;8912083;1796086;7115997
2022-01-11T09:30:00+01:00;6;Steiermark;16852209;3141908;13710301
2022-01-11T09:30:00+01:00;7;Tirol;7547639;2059758;5487881
2022-01-11T09:30:00+01:00;8;Vorarlberg;6019178;813617;5205561
2022-01-11T09:30:00+01:00;9;Wien;37417656;30208246;7209410
2022-01-11T09:30:00+01:00;10;Österreich;127820079;48465359;79354720
2022-01-12T09:30:00+01:00;1;Burgenland;3785291;737257;3048034
2022-01-12T09:30:00+01:00;2;Kärnten;5740202;921177;4819025
2022-01-12T09:30:00+01:00;3;Niederösterreich;22664198;5773667;16890531
2022-01-12T09:30:00+01:00;4;Oberösterreich;19782133;3402027;16380106
2022-01-12T09:30:00+01:00;5;Salzburg;8953604;1825106;7128498
2022-01-12T09:30:00+01:00;6;Steiermark;16885375;3149248;13736127
2022-01-12T09:30:00+01:00;7;Tirol;7576891;2080122;5496769
2022-01-12T09:30:00+01:00;8;Vorarlberg;6032460;823327;5209133
2022-01-12T09:30:00+01:00;9;Wien;37869913;30658012;7211901
2022-01-12T09:30:00+01:00;10;Österreich;129290067;49369943;79920124
2022-01-13T09:30:00+01:00;1;Burgenland;3801591;748225;3053366
2022-01-13T09:30:00+01:00;2;Kärnten;5752431;931700;4820731
2022-01-13T09:30:00+01:00;3;Niederösterreich;22696468;5798504;16897964
2022-01-13T09:30:00+01:00;4;Oberösterreich;19835340;3441811;16393529
2022-01-13T09:30:00+01:00;5;Salzburg;8994487;1850959;7143528
2022-01-13T09:30:00+01:00;6;Steiermark;16921101;3160815;13760286
2022-01-13T09:30:00+01:00;7;Tirol;7601199;2101562;5499637
2022-01-13T09:30:00+01:00;8;Vorarlberg;6043559;831081;5212478
2022-01-13T09:30:00+01:00;9;Wien;38126082;30911834;7214248
2022-01-13T09:30:00+01:00;10;Österreich;129772258;49776491;79995767
2022-01-14T09:30:00+01:00;1;Burgenland;3813904;755233;3058671
2022-01-14T09:30:00+01:00;2;Kärnten;5772703;945927;4826776
2022-01-14T09:30:00+01:00;3;Niederösterreich;22732429;5823798;16908631
2022-01-14T09:30:00+01:00;4;Oberösterreich;19921717;3490063;16431654
2022-01-14T09:30:00+01:00;5;Salzburg;9026932;1871968;7154964
2022-01-14T09:30:00+01:00;6;Steiermark;17006521;3219390;13787131
2022-01-14T09:30:00+01:00;7;Tirol;7625039;2122687;5502352
2022-01-14T09:30:00+01:00;8;Vorarlberg;6056424;840418;5216006
2022-01-14T09:30:00+01:00;9;Wien;38553038;31336421;7216617
2022-01-14T09:30:00+01:00;10;Österreich;130508707;50405905;80102802
2022-01-15T09:30:00+01:00;1;Burgenland;3839700;763514;3076186
2022-01-15T09:30:00+01:00;2;Kärnten;5781469;952564;4828905
2022-01-15T09:30:00+01:00;3;Niederösterreich;22766806;5850458;16916348
2022-01-15T09:30:00+01:00;4;Oberösterreich;19965939;3527489;16438450
2022-01-15T09:30:00+01:00;5;Salzburg;9056067;1891471;7164596
2022-01-15T09:30:00+01:00;6;Steiermark;17050957;3252668;13798289
2022-01-15T09:30:00+01:00;7;Tirol;7649417;2144947;5504470
2022-01-15T09:30:00+01:00;8;Vorarlberg;6067170;848140;5219030
2022-01-15T09:30:00+01:00;9;Wien;38831297;31612323;7218974
2022-01-15T09:30:00+01:00;10;Österreich;131008822;50843574;80165248
2022-01-16T09:30:00+01:00;1;Burgenland;3853572;775407;3078165
2022-01-16T09:30:00+01:00;2;Kärnten;5787106;958201;4828905
2022-01-16T09:30:00+01:00;3;Niederösterreich;23103129;5878236;17224893
2022-01-16T09:30:00+01:00;4;Oberösterreich;20011683;3568934;16442749
2022-01-16T09:30:00+01:00;5;Salzburg;9086207;1911522;7174685
2022-01-16T09:30:00+01:00;6;Steiermark;17090825;3283357;13807468
2022-01-16T09:30:00+01:00;7;Tirol;7677974;2171389;5506585
2022-01-16T09:30:00+01:00;8;Vorarlberg;6075618;855049;5220569
2022-01-16T09:30:00+01:00;9;Wien;39051052;31829702;7221350
2022-01-16T09:30:00+01:00;10;Österreich;131737166;51231797;80505369
2022-01-17T09:30:00+01:00;1;Burgenland;3866337;784542;3081795
2022-01-17T09:30:00+01:00;2;Kärnten;5798816;969911;4828905
2022-01-17T09:30:00+01:00;3;Niederösterreich;23140954;5909995;17230959
2022-01-17T09:30:00+01:00;4;Oberösterreich;20069844;3617567;16452277
2022-01-17T09:30:00+01:00;5;Salzburg;9114633;1930664;7183969
2022-01-17T09:30:00+01:00;6;Steiermark;17111393;3296954;13814439
2022-01-17T09:30:00+01:00;7;Tirol;7700571;2189991;5510580
2022-01-17T09:30:00+01:00;8;Vorarlberg;6087296;864398;5222898
2022-01-17T09:30:00+01:00;9;Wien;39300330;32052976;7247354
2022-01-17T09:30:00+01:00;10;Österreich;132190174;51616998;80573176
2022-01-18T09:30:00+01:00;1;Burgenland;3879249;790071;3089178
2022-01-18T09:30:00+01:00;2;Kärnten;5809091;973624;4835467
2022-01-18T09:30:00+01:00;3;Niederösterreich;23194896;5950377;17244519
2022-01-18T09:30:00+01:00;4;Oberösterreich;20117729;3655013;16462716
2022-01-18T09:30:00+01:00;5;Salzburg;9144134;1938809;7205325
2022-01-18T09:30:00+01:00;6;Steiermark;17169990;3338438;13831552
2022-01-18T09:30:00+01:00;7;Tirol;7728534;2214943;5513591
2022-01-18T09:30:00+01:00;8;Vorarlberg;6098085;871020;5227065
2022-01-18T09:30:00+01:00;9;Wien;39580897;32329919;7250978
2022-01-18T09:30:00+01:00;10;Österreich;132722605;52062214;80660391
2022-01-19T09:30:00+01:00;1;Burgenland;3901949;806943;3095006
2022-01-19T09:30:00+01:00;2;Kärnten;5825172;989378;4835794
2022-01-19T09:30:00+01:00;3;Niederösterreich;23304302;5976901;17327401
2022-01-19T09:30:00+01:00;4;Oberösterreich;20215294;3716560;16498734
2022-01-19T09:30:00+01:00;5;Salzburg;9189783;1970219;7219564
2022-01-19T09:30:00+01:00;6;Steiermark;17249708;3378676;13871032
2022-01-19T09:30:00+01:00;7;Tirol;7770580;2241474;5529106
2022-01-19T09:30:00+01:00;8;Vorarlberg;6113883;883304;5230579
2022-01-19T09:30:00+01:00;9;Wien;39994294;32741008;7253286
2022-01-19T09:30:00+01:00;10;Österreich;133564965;52704463;80860502
2022-01-20T09:30:00+01:00;1;Burgenland;3915673;814104;3101569
2022-01-20T09:30:00+01:00;2;Kärnten;5833224;995222;4838002
2022-01-20T09:30:00+01:00;3;Niederösterreich;24206613;6187486;18019127
2022-01-20T09:30:00+01:00;4;Oberösterreich;20257603;3750115;16507488
2022-01-20T09:30:00+01:00;5;Salzburg;9222345;1990177;7232168
2022-01-20T09:30:00+01:00;6;Steiermark;17293094;3409627;13883467
2022-01-20T09:30:00+01:00;7;Tirol;7801635;2269373;5532262
2022-01-20T09:30:00+01:00;8;Vorarlberg;6126656;892881;5233775
2022-01-20T09:30:00+01:00;9;Wien;40296399;33040577;7255822
2022-01-20T09:30:00+01:00;10;Österreich;134953242;53349562;81603680
2022-01-21T09:30:00+01:00;1;Burgenland;3933136;825417;3107719
2022-01-21T09:30:00+01:00;2;Kärnten;5851414;1006614;4844800
2022-01-21T09:30:00+01:00;3;Niederösterreich;24234254;6206356;18027898
2022-01-21T09:30:00+01:00;4;Oberösterreich;20320218;3804725;16515493
2022-01-21T09:30:00+01:00;5;Salzburg;9237586;2005418;7232168
2022-01-21T09:30:00+01:00;6;Steiermark;17336479;3440578;13895901
2022-01-21T09:30:00+01:00;7;Tirol;7830643;2295820;5534823
2022-01-21T09:30:00+01:00;8;Vorarlberg;6139293;902207;5237086
2022-01-21T09:30:00+01:00;9;Wien;40686999;33428837;7258162
2022-01-21T09:30:00+01:00;10;Österreich;135570022;53915972;81654050
2022-01-22T09:30:00+01:00;1;Burgenland;3953631;836804;3116827
2022-01-22T09:30:00+01:00;2;Kärnten;5865692;1019415;4846277
2022-01-22T09:30:00+01:00;3;Niederösterreich;24283465;6249785;18033680
2022-01-22T09:30:00+01:00;4;Oberösterreich;20364434;3838538;16525896
2022-01-22T09:30:00+01:00;5;Salzburg;9284786;2031782;7253004
2022-01-22T09:30:00+01:00;6;Steiermark;17389046;3481228;13907818
2022-01-22T09:30:00+01:00;7;Tirol;7857192;2320310;5536882
2022-01-22T09:30:00+01:00;8;Vorarlberg;6151486;910838;5240648
2022-01-22T09:30:00+01:00;9;Wien;40959563;33697593;7261970
2022-01-22T09:30:00+01:00;10;Österreich;136109295;54386293;81723002
2022-01-23T09:30:00+01:00;1;Burgenland;3973293;853863;3119430
2022-01-23T09:30:00+01:00;2;Kärnten;5876156;1029879;4846277
2022-01-23T09:30:00+01:00;3;Niederösterreich;24329848;6287495;18042353
2022-01-23T09:30:00+01:00;4;Oberösterreich;20419279;3886300;16532979
2022-01-23T09:30:00+01:00;5;Salzburg;9312398;2050094;7262304
2022-01-23T09:30:00+01:00;6;Steiermark;17422502;3504722;13917780
2022-01-23T09:30:00+01:00;7;Tirol;7882570;2343796;5538774
2022-01-23T09:30:00+01:00;8;Vorarlberg;6161511;918777;5242734
2022-01-23T09:30:00+01:00;9;Wien;41196885;33930853;7266032
2022-01-23T09:30:00+01:00;10;Österreich;136574442;54805779;81768663
2022-01-24T09:30:00+01:00;1;Burgenland;3983283;861796;3121487
2022-01-24T09:30:00+01:00;2;Kärnten;5882237;1035569;4846668
2022-01-24T09:30:00+01:00;3;Niederösterreich;24364587;6316649;18047938
2022-01-24T09:30:00+01:00;4;Oberösterreich;20477796;3929701;16548095
2022-01-24T09:30:00+01:00;5;Salzburg;9338987;2067892;7271095
2022-01-24T09:30:00+01:00;6;Steiermark;17470879;3529600;13941279
2022-01-24T09:30:00+01:00;7;Tirol;7906103;2363899;5542204
2022-01-24T09:30:00+01:00;8;Vorarlberg;6174173;928194;5245979
2022-01-24T09:30:00+01:00;9;Wien;41434018;34163121;7270897
2022-01-24T09:30:00+01:00;10;Österreich;137032063;55196421;81835642
2022-01-25T09:30:00+01:00;1;Burgenland;4013890;873626;3140264
2022-01-25T09:30:00+01:00;2;Kärnten;5886548;1039880;4846668
2022-01-25T09:30:00+01:00;3;Niederösterreich;24423844;6362060;18061784
2022-01-25T09:30:00+01:00;4;Oberösterreich;20530761;3962395;16568366
2022-01-25T09:30:00+01:00;5;Salzburg;9360154;2080260;7279894
2022-01-25T09:30:00+01:00;6;Steiermark;17523615;3563788;13959827
2022-01-25T09:30:00+01:00;7;Tirol;7939337;2393922;5545415
2022-01-25T09:30:00+01:00;8;Vorarlberg;6187749;935571;5252178
2022-01-25T09:30:00+01:00;9;Wien;41700161;34424030;7276131
2022-01-25T09:30:00+01:00;10;Österreich;137566059;55635532;81930527
2022-01-26T09:30:00+01:00;1;Burgenland;4026498;879500;3146998
2022-01-26T09:30:00+01:00;2;Kärnten;5910181;1056692;4853489
2022-01-26T09:30:00+01:00;3;Niederösterreich;24481072;6398866;18082206
2022-01-26T09:30:00+01:00;4;Oberösterreich;20613144;4023931;16589213
2022-01-26T09:30:00+01:00;5;Salzburg;9395059;2103161;7291898
2022-01-26T09:30:00+01:00;6;Steiermark;17611177;3608720;14002457
2022-01-26T09:30:00+01:00;7;Tirol;7983994;2422099;5561895
2022-01-26T09:30:00+01:00;8;Vorarlberg;6204052;946829;5257223
2022-01-26T09:30:00+01:00;9;Wien;42132019;34852129;7279890
2022-01-26T09:30:00+01:00;10;Österreich;138357196;56291927;82065269
2022-01-27T09:30:00+01:00;1;Burgenland;4040301;887310;3152991
2022-01-27T09:30:00+01:00;2;Kärnten;5929153;1066375;4862778
2022-01-27T09:30:00+01:00;3;Niederösterreich;25668339;6766870;18901469
2022-01-27T09:30:00+01:00;4;Oberösterreich;20665449;4068584;16596865
2022-01-27T09:30:00+01:00;5;Salzburg;9422065;2126649;7295416
2022-01-27T09:30:00+01:00;6;Steiermark;17660664;3643791;14016873
2022-01-27T09:30:00+01:00;7;Tirol;8017152;2452459;5564693
2022-01-27T09:30:00+01:00;8;Vorarlberg;6219149;957131;5262018
2022-01-27T09:30:00+01:00;9;Wien;42470467;35186723;7283744
2022-01-27T09:30:00+01:00;10;Österreich;140092739;57155892;82936847
2022-01-28T09:30:00+01:00;1;Burgenland;4063824;904351;3159473
2022-01-28T09:30:00+01:00;2;Kärnten;5937600;1074822;4862778
2022-01-28T09:30:00+01:00;3;Niederösterreich;25706282;6794750;18911532
2022-01-28T09:30:00+01:00;4;Oberösterreich;20763739;4116009;16647730
2022-01-28T09:30:00+01:00;5;Salzburg;9444151;2145192;7298959
2022-01-28T09:30:00+01:00;6;Steiermark;17719999;3690264;14029735
2022-01-28T09:30:00+01:00;7;Tirol;8045869;2478590;5567279
2022-01-28T09:30:00+01:00;8;Vorarlberg;6235267;968465;5266802
2022-01-28T09:30:00+01:00;9;Wien;42877627;35590238;7287389
2022-01-28T09:30:00+01:00;10;Österreich;140794358;57762681;83031677
2022-01-29T09:30:00+01:00;1;Burgenland;4099137;917611;3181526
2022-01-29T09:30:00+01:00;2;Kärnten;5945038;1080513;4864525
2022-01-29T09:30:00+01:00;3;Niederösterreich;25769712;6847709;18922003
2022-01-29T09:30:00+01:00;4;Oberösterreich;20823577;4161590;16661987
2022-01-29T09:30:00+01:00;5;Salzburg;9466974;2164531;7302443
2022-01-29T09:30:00+01:00;6;Steiermark;17762242;3719634;14042608
2022-01-29T09:30:00+01:00;7;Tirol;8073768;2504618;5569150
2022-01-29T09:30:00+01:00;8;Vorarlberg;6250047;978944;5271103
2022-01-29T09:30:00+01:00;9;Wien;43171997;35881312;7290685
2022-01-29T09:30:00+01:00;10;Österreich;141362492;58256462;83106030
2022-01-30T09:30:00+01:00;1;Burgenland;4114617;931024;3183593
2022-01-30T09:30:00+01:00;2;Kärnten;5953336;1088811;4864525
2022-01-30T09:30:00+01:00;3;Niederösterreich;25803569;6876657;18926912
2022-01-30T09:30:00+01:00;4;Oberösterreich;20872541;4202140;16670401
2022-01-30T09:30:00+01:00;5;Salzburg;9487988;2183134;7304854
2022-01-30T09:30:00+01:00;6;Steiermark;17800593;3747346;14053247
2022-01-30T09:30:00+01:00;7;Tirol;8095693;2524511;5571182
2022-01-30T09:30:00+01:00;8;Vorarlberg;6261669;988228;5273441
2022-01-30T09:30:00+01:00;9;Wien;43398272;36104458;7293814
2022-01-30T09:30:00+01:00;10;Österreich;141788278;58646309;83141969
2022-01-31T09:30:00+01:00;1;Burgenland;4125173;937934;3187239
2022-01-31T09:30:00+01:00;2;Kärnten;5964973;1100448;4864525
2022-01-31T09:30:00+01:00;3;Niederösterreich;25850361;6917658;18932703
2022-01-31T09:30:00+01:00;4;Oberösterreich;20936302;4250381;16685921
2022-01-31T09:30:00+01:00;5;Salzburg;9504203;2198282;7305921
2022-01-31T09:30:00+01:00;6;Steiermark;17839135;3777832;14061303
2022-01-31T09:30:00+01:00;7;Tirol;8118062;2543442;5574620
2022-01-31T09:30:00+01:00;8;Vorarlberg;6274734;997994;5276740
2022-01-31T09:30:00+01:00;9;Wien;43467398;36169460;7297938
2022-01-31T09:30:00+01:00;10;Österreich;142080341;58893431;83186910
2022-02-01T09:30:00+01:00;1;Burgenland;4143063;948117;3194946
2022-02-01T09:30:00+01:00;2;Kärnten;5974145;1105590;4868555
2022-02-01T09:30:00+01:00;3;Niederösterreich;25908016;6961340;18946676
2022-02-01T09:30:00+01:00;4;Oberösterreich;20984306;4286677;16697629
2022-02-01T09:30:00+01:00;5;Salzburg;9532998;2212951;7320047
2022-02-01T09:30:00+01:00;6;Steiermark;17881334;3801505;14079829
2022-02-01T09:30:00+01:00;7;Tirol;8154216;2576723;5577493
2022-02-01T09:30:00+01:00;8;Vorarlberg;6289018;1006067;5282951
2022-02-01T09:30:00+01:00;9;Wien;43922057;36619684;7302373
2022-02-01T09:30:00+01:00;10;Österreich;142789153;59518654;83270499
2022-02-02T09:30:00+01:00;1;Burgenland;4159355;957197;3202158
2022-02-02T09:30:00+01:00;2;Kärnten;5988089;1112798;4875291
2022-02-02T09:30:00+01:00;3;Niederösterreich;26389128;7243472;19145656
2022-02-02T09:30:00+01:00;4;Oberösterreich;21062606;4344341;16718265
2022-02-02T09:30:00+01:00;5;Salzburg;9558737;2234951;7323786
2022-02-02T09:30:00+01:00;6;Steiermark;18006163;3825189;14180974
2022-02-02T09:30:00+01:00;7;Tirol;8188230;2597589;5590641
2022-02-02T09:30:00+01:00;8;Vorarlberg;6308390;1019827;5288563
2022-02-02T09:30:00+01:00;9;Wien;44352378;37047703;7304675
2022-02-02T09:30:00+01:00;10;Österreich;144013076;60383067;83630009
2022-02-03T09:30:00+01:00;1;Burgenland;4182101;973004;3209097
2022-02-03T09:30:00+01:00;2;Kärnten;6004429;1127244;4877185
2022-02-03T09:30:00+01:00;3;Niederösterreich;26951833;7279893;19671940
2022-02-03T09:30:00+01:00;4;Oberösterreich;21152784;4376622;16776162
2022-02-03T09:30:00+01:00;5;Salzburg;9579558;2252067;7327491
2022-02-03T09:30:00+01:00;6;Steiermark;18100807;3906069;14194738
2022-02-03T09:30:00+01:00;7;Tirol;8209465;2616372;5593093
2022-02-03T09:30:00+01:00;8;Vorarlberg;6324473;1030714;5293759
2022-02-03T09:30:00+01:00;9;Wien;44668822;37360246;7308576
2022-02-03T09:30:00+01:00;10;Österreich;145174272;60922231;84252041
2022-02-04T09:30:00+01:00;1;Burgenland;4203064;987609;3215455
2022-02-04T09:30:00+01:00;2;Kärnten;6015106;1137921;4877185
2022-02-04T09:30:00+01:00;3;Niederösterreich;27021095;7339595;19681500
2022-02-04T09:30:00+01:00;4;Oberösterreich;21216625;4423158;16793467
2022-02-04T09:30:00+01:00;5;Salzburg;9602058;2270935;7331123
2022-02-04T09:30:00+01:00;6;Steiermark;18144430;3937941;14206489
2022-02-04T09:30:00+01:00;7;Tirol;8254049;2658625;5595424
2022-02-04T09:30:00+01:00;8;Vorarlberg;6340925;1042138;5298787
2022-02-04T09:30:00+01:00;9;Wien;44973659;37661474;7312185
2022-02-04T09:30:00+01:00;10;Österreich;145771011;61459396;84311615
2022-02-05T09:30:00+01:00;1;Burgenland;4226485;996739;3229746
2022-02-05T09:30:00+01:00;2;Kärnten;6026479;1141907;4884572
2022-02-05T09:30:00+01:00;3;Niederösterreich;27083740;7392037;19691703
2022-02-05T09:30:00+01:00;4;Oberösterreich;21271164;4463187;16807977
2022-02-05T09:30:00+01:00;5;Salzburg;9622065;2287431;7334634
2022-02-05T09:30:00+01:00;6;Steiermark;18181604;3962810;14218794
2022-02-05T09:30:00+01:00;7;Tirol;8282027;2684882;5597145
2022-02-05T09:30:00+01:00;8;Vorarlberg;6356482;1053132;5303350
2022-02-05T09:30:00+01:00;9;Wien;45266877;37951022;7315855
2022-02-05T09:30:00+01:00;10;Österreich;146316923;61933147;84383776
2022-02-06T09:30:00+01:00;1;Burgenland;4249354;1012062;3237292
2022-02-06T09:30:00+01:00;2;Kärnten;6031510;1146938;4884572
2022-02-06T09:30:00+01:00;3;Niederösterreich;27120223;7424387;19695836
2022-02-06T09:30:00+01:00;4;Oberösterreich;21320052;4504238;16815814
2022-02-06T09:30:00+01:00;5;Salzburg;9640905;2303929;7336976
2022-02-06T09:30:00+01:00;6;Steiermark;18247532;4018550;14228982
2022-02-06T09:30:00+01:00;7;Tirol;8308570;2709678;5598892
2022-02-06T09:30:00+01:00;8;Vorarlberg;6368730;1063074;5305656
2022-02-06T09:30:00+01:00;9;Wien;45522433;38203317;7319116
2022-02-06T09:30:00+01:00;10;Österreich;146809309;62386173;84423136
2022-02-07T09:30:00+01:00;1;Burgenland;4263560;1022968;3240592
2022-02-07T09:30:00+01:00;2;Kärnten;6039963;1155122;4884841
2022-02-07T09:30:00+01:00;3;Niederösterreich;27284108;7583636;19700472
2022-02-07T09:30:00+01:00;4;Oberösterreich;21376778;4545819;16830959
2022-02-07T09:30:00+01:00;5;Salzburg;9656365;2318291;7338074
2022-02-07T09:30:00+01:00;6;Steiermark;18288792;4052529;14236263
2022-02-07T09:30:00+01:00;7;Tirol;8328886;2726883;5602003
2022-02-07T09:30:00+01:00;8;Vorarlberg;6381253;1072615;5308638
2022-02-07T09:30:00+01:00;9;Wien;45606732;38283527;7323205
2022-02-07T09:30:00+01:00;10;Österreich;147226437;62761390;84465047
2022-02-08T09:30:00+01:00;1;Burgenland;4281132;1032426;3248706
2022-02-08T09:30:00+01:00;2;Kärnten;6053524;1159557;4893967
2022-02-08T09:30:00+01:00;3;Niederösterreich;27395519;7645958;19749561
2022-02-08T09:30:00+01:00;4;Oberösterreich;21440587;4586665;16853922
2022-02-08T09:30:00+01:00;5;Salzburg;9679861;2329437;7350424
2022-02-08T09:30:00+01:00;6;Steiermark;18339150;4085909;14253241
2022-02-08T09:30:00+01:00;7;Tirol;8361580;2757242;5604338
2022-02-08T09:30:00+01:00;8;Vorarlberg;6396114;1081222;5314892
2022-02-08T09:30:00+01:00;9;Wien;45904905;38577669;7327236
2022-02-08T09:30:00+01:00;10;Österreich;147852372;63256085;84596287
2022-02-09T09:30:00+01:00;1;Burgenland;4296308;1041286;3255022
2022-02-09T09:30:00+01:00;2;Kärnten;6069048;1171098;4897950
2022-02-09T09:30:00+01:00;3;Niederösterreich;27636658;7697188;19939470
2022-02-09T09:30:00+01:00;4;Oberösterreich;21534732;4630592;16904140
2022-02-09T09:30:00+01:00;5;Salzburg;9705982;2351928;7354054
2022-02-09T09:30:00+01:00;6;Steiermark;18421111;4122434;14298677
2022-02-09T09:30:00+01:00;7;Tirol;8396341;2781178;5615163
2022-02-09T09:30:00+01:00;8;Vorarlberg;6412604;1092815;5319789
2022-02-09T09:30:00+01:00;9;Wien;46137789;38807577;7330212
2022-02-09T09:30:00+01:00;10;Österreich;148610573;63696096;84914477
2022-02-10T09:30:00+01:00;1;Burgenland;4314837;1053639;3261198
2022-02-10T09:30:00+01:00;2;Kärnten;6081167;1183217;4897950
2022-02-10T09:30:00+01:00;3;Niederösterreich;27992914;7747239;20245675
2022-02-10T09:30:00+01:00;4;Oberösterreich;21584338;4664045;16920293
2022-02-10T09:30:00+01:00;5;Salzburg;9726344;2369093;7357251
2022-02-10T09:30:00+01:00;6;Steiermark;18473481;4162110;14311371
2022-02-10T09:30:00+01:00;7;Tirol;8423259;2805955;5617304
2022-02-10T09:30:00+01:00;8;Vorarlberg;6428631;1104117;5324514
2022-02-10T09:30:00+01:00;9;Wien;46414303;39081007;7333296
2022-02-10T09:30:00+01:00;10;Österreich;149439274;64170422;85268852
2022-02-11T09:30:00+01:00;1;Burgenland;4332440;1065278;3267162
2022-02-11T09:30:00+01:00;2;Kärnten;6088079;1187566;4900513
2022-02-11T09:30:00+01:00;3;Niederösterreich;28028714;7773667;20255047
2022-02-11T09:30:00+01:00;4;Oberösterreich;21641085;4705800;16935285
2022-02-11T09:30:00+01:00;5;Salzburg;9746241;2385906;7360335
2022-02-11T09:30:00+01:00;6;Steiermark;18523089;4201071;14322018
2022-02-11T09:30:00+01:00;7;Tirol;8447457;2828257;5619200
2022-02-11T09:30:00+01:00;8;Vorarlberg;6443443;1114174;5329269
2022-02-11T09:30:00+01:00;9;Wien;46618103;39281905;7336198
2022-02-11T09:30:00+01:00;10;Österreich;149868651;64543624;85325027
2022-02-12T09:30:00+01:00;1;Burgenland;4360787;1075890;3284897
2022-02-12T09:30:00+01:00;2;Kärnten;6105871;1199898;4905973
2022-02-12T09:30:00+01:00;3;Niederösterreich;28334496;7978361;20356135
2022-02-12T09:30:00+01:00;4;Oberösterreich;21682930;4734581;16948349
2022-02-12T09:30:00+01:00;5;Salzburg;9762908;2399482;7363426
2022-02-12T09:30:00+01:00;6;Steiermark;18568099;4234401;14333698
2022-02-12T09:30:00+01:00;7;Tirol;8471990;2851239;5620751
2022-02-12T09:30:00+01:00;8;Vorarlberg;6456546;1123261;5333285
2022-02-12T09:30:00+01:00;9;Wien;46806825;39467846;7338979
2022-02-12T09:30:00+01:00;10;Österreich;150550452;65064959;85485493
2022-02-13T09:30:00+01:00;1;Burgenland;4371256;1086050;3285206
2022-02-13T09:30:00+01:00;2;Kärnten;6111340;1205367;4905973
2022-02-13T09:30:00+01:00;3;Niederösterreich;28372956;8012694;20360262
2022-02-13T09:30:00+01:00;4;Oberösterreich;21742383;4783729;16958654
2022-02-13T09:30:00+01:00;5;Salzburg;9780502;2414578;7365924
2022-02-13T09:30:00+01:00;6;Steiermark;18606504;4263306;14343198
2022-02-13T09:30:00+01:00;7;Tirol;8493817;2871554;5622263
2022-02-13T09:30:00+01:00;8;Vorarlberg;6467281;1131683;5335598
2022-02-13T09:30:00+01:00;9;Wien;46973605;39631773;7341832
2022-02-13T09:30:00+01:00;10;Österreich;150919644;65400734;85518910
2022-02-14T09:30:00+01:00;1;Burgenland;4383728;1093737;3289991
2022-02-14T09:30:00+01:00;2;Kärnten;6117399;1211426;4905973
2022-02-14T09:30:00+01:00;3;Niederösterreich;28415840;8050250;20365590
2022-02-14T09:30:00+01:00;4;Oberösterreich;21792488;4820246;16972242
2022-02-14T09:30:00+01:00;5;Salzburg;9792631;2425764;7366867
2022-02-14T09:30:00+01:00;6;Steiermark;18643448;4293236;14350212
2022-02-14T09:30:00+01:00;7;Tirol;8510625;2885669;5624956
2022-02-14T09:30:00+01:00;8;Vorarlberg;6478553;1140369;5338184
2022-02-14T09:30:00+01:00;9;Wien;47036495;39690555;7345940
2022-02-14T09:30:00+01:00;10;Österreich;151171207;65611252;85559955
2022-02-15T09:30:00+01:00;1;Burgenland;4392458;1101719;3290739
2022-02-15T09:30:00+01:00;2;Kärnten;6126968;1214139;4912829
2022-02-15T09:30:00+01:00;3;Niederösterreich;28509940;8101870;20408070
2022-02-15T09:30:00+01:00;4;Oberösterreich;21884307;4854232;17030075
2022-02-15T09:30:00+01:00;5;Salzburg;9816053;2436899;7379154
2022-02-15T09:30:00+01:00;6;Steiermark;18683620;4318686;14364934
2022-02-15T09:30:00+01:00;7;Tirol;8538525;2911444;5627081
2022-02-15T09:30:00+01:00;8;Vorarlberg;6490949;1147619;5343330
2022-02-15T09:30:00+01:00;9;Wien;47438236;40089704;7348532
2022-02-15T09:30:00+01:00;10;Österreich;151881056;66176312;85704744
2022-02-16T09:30:00+01:00;1;Burgenland;4411788;1109947;3301841
2022-02-16T09:30:00+01:00;2;Kärnten;6140791;1226204;4914587
2022-02-16T09:30:00+01:00;3;Niederösterreich;28803482;8288740;20514742
2022-02-16T09:30:00+01:00;4;Oberösterreich;21946608;4893025;17053583
2022-02-16T09:30:00+01:00;5;Salzburg;9835024;2452543;7382481
2022-02-16T09:30:00+01:00;6;Steiermark;18769513;4361341;14408172
2022-02-16T09:30:00+01:00;7;Tirol;8568222;2931235;5636987
2022-02-16T09:30:00+01:00;8;Vorarlberg;6502109;1154716;5347393
2022-02-16T09:30:00+01:00;9;Wien;47845622;40495550;7350072
2022-02-16T09:30:00+01:00;10;Österreich;152823159;66913301;85909858
2022-02-17T09:30:00+01:00;1;Burgenland;4425694;1119151;3306543
2022-02-17T09:30:00+01:00;2;Kärnten;6147610;1228435;4919175
2022-02-17T09:30:00+01:00;3;Niederösterreich;29058471;8340482;20717989
2022-02-17T09:30:00+01:00;4;Oberösterreich;22022761;4926275;17096486
2022-02-17T09:30:00+01:00;5;Salzburg;9853473;2467919;7385554
2022-02-17T09:30:00+01:00;6;Steiermark;18809929;4391136;14418793
2022-02-17T09:30:00+01:00;7;Tirol;8590704;2951977;5638727
2022-02-17T09:30:00+01:00;8;Vorarlberg;6516524;1164888;5351636
2022-02-17T09:30:00+01:00;9;Wien;48144858;40792588;7352270
2022-02-17T09:30:00+01:00;10;Österreich;153570024;67382851;86187173
2022-02-18T09:30:00+01:00;1;Burgenland;4440126;1128168;3311958
2022-02-18T09:30:00+01:00;2;Kärnten;6154764;1235589;4919175
2022-02-18T09:30:00+01:00;3;Niederösterreich;29097240;8370864;20726376
2022-02-18T09:30:00+01:00;4;Oberösterreich;22074982;4964928;17110054
2022-02-18T09:30:00+01:00;5;Salzburg;9869694;2481333;7388361
2022-02-18T09:30:00+01:00;6;Steiermark;18846722;4416984;14429738
2022-02-18T09:30:00+01:00;7;Tirol;8611340;2970733;5640607
2022-02-18T09:30:00+01:00;8;Vorarlberg;6530689;1174328;5356361
2022-02-18T09:30:00+01:00;9;Wien;48436267;41082250;7354017
2022-02-18T09:30:00+01:00;10;Österreich;154061824;67825177;86236647
2022-02-19T09:30:00+01:00;1;Burgenland;4451110;1134979;3316131
2022-02-19T09:30:00+01:00;2;Kärnten;6170548;1245280;4925268
2022-02-19T09:30:00+01:00;3;Niederösterreich;29441149;8705345;20735804
2022-02-19T09:30:00+01:00;4;Oberösterreich;22121255;4997945;17123310
2022-02-19T09:30:00+01:00;5;Salzburg;9885774;2494318;7391456
2022-02-19T09:30:00+01:00;6;Steiermark;18890760;4449992;14440768
2022-02-19T09:30:00+01:00;7;Tirol;8633049;2990919;5642130
2022-02-19T09:30:00+01:00;8;Vorarlberg;6542080;1182013;5360067
2022-02-19T09:30:00+01:00;9;Wien;48637415;41281683;7355732
2022-02-19T09:30:00+01:00;10;Österreich;154773140;68482474;86290666
2022-02-20T09:30:00+01:00;1;Burgenland;4465389;1146813;3318576
2022-02-20T09:30:00+01:00;2;Kärnten;6174146;1248878;4925268
2022-02-20T09:30:00+01:00;3;Niederösterreich;29479278;8739047;20740231
2022-02-20T09:30:00+01:00;4;Oberösterreich;22172066;5031828;17140238
2022-02-20T09:30:00+01:00;5;Salzburg;9902331;2506846;7395485
2022-02-20T09:30:00+01:00;6;Steiermark;18930185;4477423;14452762
2022-02-20T09:30:00+01:00;7;Tirol;8653804;3009695;5644109
2022-02-20T09:30:00+01:00;8;Vorarlberg;6552488;1188819;5363669
2022-02-20T09:30:00+01:00;9;Wien;48811516;41454064;7357452
2022-02-20T09:30:00+01:00;10;Österreich;155141203;68803413;86337790
2022-02-21T09:30:00+01:00;1;Burgenland;4478643;1156966;3321677
2022-02-21T09:30:00+01:00;2;Kärnten;6179765;1254497;4925268
2022-02-21T09:30:00+01:00;3;Niederösterreich;29519143;8774605;20744538
2022-02-21T09:30:00+01:00;4;Oberösterreich;22219606;5061525;17158081
2022-02-21T09:30:00+01:00;5;Salzburg;9914364;2516960;7397404
2022-02-21T09:30:00+01:00;6;Steiermark;18957944;4499008;14458936
2022-02-21T09:30:00+01:00;7;Tirol;8669354;3022529;5646825
2022-02-21T09:30:00+01:00;8;Vorarlberg;6563320;1196192;5367128
2022-02-21T09:30:00+01:00;9;Wien;48862022;41502098;7359924
2022-02-21T09:30:00+01:00;10;Österreich;155364161;68984380;86379781
2022-02-22T09:30:00+01:00;1;Burgenland;4493322;1163405;3329917
2022-02-22T09:30:00+01:00;2;Kärnten;6189837;1257353;4932484
2022-02-22T09:30:00+01:00;3;Niederösterreich;29568773;8811785;20756988
2022-02-22T09:30:00+01:00;4;Oberösterreich;22277309;5095123;17182186
2022-02-22T09:30:00+01:00;5;Salzburg;9934841;2527134;7407707
2022-02-22T09:30:00+01:00;6;Steiermark;18995438;4517922;14477516
2022-02-22T09:30:00+01:00;7;Tirol;8703762;3046172;5657590
2022-02-22T09:30:00+01:00;8;Vorarlberg;6575575;1202878;5372697
2022-02-22T09:30:00+01:00;9;Wien;49164993;41800447;7364546
2022-02-22T09:30:00+01:00;10;Österreich;155903850;69422219;86481631
2022-02-23T09:30:00+01:00;1;Burgenland;4505513;1169700;3335813
2022-02-23T09:30:00+01:00;2;Kärnten;6201476;1266026;4935450
2022-02-23T09:30:00+01:00;3;Niederösterreich;29624669;8848302;20776367
2022-02-23T09:30:00+01:00;4;Oberösterreich;22328154;5123594;17204560
2022-02-23T09:30:00+01:00;5;Salzburg;9955322;2544148;7411174
2022-02-23T09:30:00+01:00;6;Steiermark;19082164;4558058;14524106
2022-02-23T09:30:00+01:00;7;Tirol;8722709;3063401;5659308
2022-02-23T09:30:00+01:00;8;Vorarlberg;6587642;1210365;5377277
2022-02-23T09:30:00+01:00;9;Wien;49461150;42092710;7368440
2022-02-23T09:30:00+01:00;10;Österreich;156468799;69876304;86592495
2022-02-24T09:30:00+01:00;1;Burgenland;4524044;1182390;3341654
2022-02-24T09:30:00+01:00;2;Kärnten;6210362;1272745;4937617
2022-02-24T09:30:00+01:00;3;Niederösterreich;30033749;8893291;21140458
2022-02-24T09:30:00+01:00;4;Oberösterreich;22411222;5158539;17252683
2022-02-24T09:30:00+01:00;5;Salzburg;9972851;2558224;7414627
2022-02-24T09:30:00+01:00;6;Steiermark;19121170;4584150;14537020
2022-02-24T09:30:00+01:00;7;Tirol;8738459;3077363;5661096
2022-02-24T09:30:00+01:00;8;Vorarlberg;6599847;1217786;5382061
2022-02-24T09:30:00+01:00;9;Wien;49743194;42370752;7372442
2022-02-24T09:30:00+01:00;10;Österreich;157354898;70315240;87039658
2022-02-25T09:30:00+01:00;1;Burgenland;4538683;1191454;3347229
2022-02-25T09:30:00+01:00;2;Kärnten;6215373;1277756;4937617
2022-02-25T09:30:00+01:00;3;Niederösterreich;30154990;8921663;21233327
2022-02-25T09:30:00+01:00;4;Oberösterreich;22462965;5192423;17270542
2022-02-25T09:30:00+01:00;5;Salzburg;9988376;2570247;7418129
2022-02-25T09:30:00+01:00;6;Steiermark;19156542;4607591;14548951
2022-02-25T09:30:00+01:00;7;Tirol;8761383;3098472;5662911
2022-02-25T09:30:00+01:00;8;Vorarlberg;6610872;1224362;5386510
2022-02-25T09:30:00+01:00;9;Wien;49992345;42616019;7376326
2022-02-25T09:30:00+01:00;10;Österreich;157881529;70699987;87181542
2022-02-26T09:30:00+01:00;1;Burgenland;4566674;1202570;3364104
2022-02-26T09:30:00+01:00;2;Kärnten;6223205;1285588;4937617
2022-02-26T09:30:00+01:00;3;Niederösterreich;30478452;9235845;21242607
2022-02-26T09:30:00+01:00;4;Oberösterreich;22503719;5215713;17288006
2022-02-26T09:30:00+01:00;5;Salzburg;10003954;2582155;7421799
2022-02-26T09:30:00+01:00;6;Steiermark;19199244;4637289;14561955
2022-02-26T09:30:00+01:00;7;Tirol;8781334;3116756;5664578
2022-02-26T09:30:00+01:00;8;Vorarlberg;6621649;1230877;5390772
2022-02-26T09:30:00+01:00;9;Wien;50220579;42840549;7380030
2022-02-26T09:30:00+01:00;10;Österreich;158598810;71347342;87251468
2022-02-27T09:30:00+01:00;1;Burgenland;4579061;1212867;3366194
2022-02-27T09:30:00+01:00;2;Kärnten;6233316;1290645;4942671
2022-02-27T09:30:00+01:00;3;Niederösterreich;30516723;9269908;21246815
2022-02-27T09:30:00+01:00;4;Oberösterreich;22549788;5245770;17304018
2022-02-27T09:30:00+01:00;5;Salzburg;10018323;2593090;7425233
2022-02-27T09:30:00+01:00;6;Steiermark;19233401;4659086;14574315
2022-02-27T09:30:00+01:00;7;Tirol;8800447;3133990;5666457
2022-02-27T09:30:00+01:00;8;Vorarlberg;6631505;1237349;5394156
2022-02-27T09:30:00+01:00;9;Wien;50379094;42995290;7383804
2022-02-27T09:30:00+01:00;10;Österreich;158941658;71637995;87303663
2022-02-28T09:30:00+01:00;1;Burgenland;4589308;1220520;3368788
2022-02-28T09:30:00+01:00;2;Kärnten;6235639;1292968;4942671
2022-02-28T09:30:00+01:00;3;Niederösterreich;30552381;9301809;21250572
2022-02-28T09:30:00+01:00;4;Oberösterreich;22600374;5277990;17322384
2022-02-28T09:30:00+01:00;5;Salzburg;10030012;2602769;7427243
2022-02-28T09:30:00+01:00;6;Steiermark;19260366;4676034;14584332
2022-02-28T09:30:00+01:00;7;Tirol;8814459;3145460;5668999
2022-02-28T09:30:00+01:00;8;Vorarlberg;6641146;1243571;5397575
2022-02-28T09:30:00+01:00;9;Wien;50427856;43039544;7388312
2022-02-28T09:30:00+01:00;10;Österreich;159151541;71800665;87350876
2022-03-01T09:30:00+01:00;1;Burgenland;4600528;1226109;3374419
2022-03-01T09:30:00+01:00;2;Kärnten;6238720;1296008;4942712
2022-03-01T09:30:00+01:00;3;Niederösterreich;30607107;9346023;21261084
2022-03-01T09:30:00+01:00;4;Oberösterreich;22656619;5310834;17345785
2022-03-01T09:30:00+01:00;5;Salzburg;10052104;2614763;7437341
2022-03-01T09:30:00+01:00;6;Steiermark;19305566;4706942;14598624
2022-03-01T09:30:00+01:00;7;Tirol;8838461;3167407;5671054
2022-03-01T09:30:00+01:00;8;Vorarlberg;6652575;1249722;5402853
2022-03-01T09:30:00+01:00;9;Wien;50704949;43313990;7390959
2022-03-01T09:30:00+01:00;10;Österreich;159656629;72231798;87424831
2022-03-02T09:30:00+01:00;1;Burgenland;4611592;1232813;3378779
2022-03-02T09:30:00+01:00;2;Kärnten;6245590;1302878;4942712
2022-03-02T09:30:00+01:00;3;Niederösterreich;30961004;9492058;21468946
2022-03-02T09:30:00+01:00;4;Oberösterreich;22697776;5333083;17364693
2022-03-02T09:30:00+01:00;5;Salzburg;10070098;2629076;7441022
2022-03-02T09:30:00+01:00;6;Steiermark;19345418;4735325;14610093
2022-03-02T09:30:00+01:00;7;Tirol;8864497;3184382;5680115
2022-03-02T09:30:00+01:00;8;Vorarlberg;6664855;1257520;5407335
2022-03-02T09:30:00+01:00;9;Wien;51042999;43650051;7392948
2022-03-02T09:30:00+01:00;10;Österreich;160503829;72817186;87686643
2022-03-03T09:30:00+01:00;1;Burgenland;4626761;1244164;3382597
2022-03-03T09:30:00+01:00;2;Kärnten;6264602;1310323;4954279
2022-03-03T09:30:00+01:00;3;Niederösterreich;31303849;9529795;21774054
2022-03-03T09:30:00+01:00;4;Oberösterreich;22767886;5360840;17407046
2022-03-03T09:30:00+01:00;5;Salzburg;10085786;2641455;7444331
2022-03-03T09:30:00+01:00;6;Steiermark;19409586;4758962;14650624
2022-03-03T09:30:00+01:00;7;Tirol;8885261;3203357;5681904
2022-03-03T09:30:00+01:00;8;Vorarlberg;6676232;1264653;5411579
2022-03-03T09:30:00+01:00;9;Wien;51285162;43890184;7394978
2022-03-03T09:30:00+01:00;10;Österreich;161305125;73203733;88101392
2022-03-04T09:30:00+01:00;1;Burgenland;4639604;1253166;3386438
2022-03-04T09:30:00+01:00;2;Kärnten;6277919;1314010;4963909
2022-03-04T09:30:00+01:00;3;Niederösterreich;31336870;9555790;21781080
2022-03-04T09:30:00+01:00;4;Oberösterreich;22815447;5393001;17422446
2022-03-04T09:30:00+01:00;5;Salzburg;10102022;2654185;7447837
2022-03-04T09:30:00+01:00;6;Steiermark;19444275;4782702;14661573
2022-03-04T09:30:00+01:00;7;Tirol;8903384;3219728;5683656
2022-03-04T09:30:00+01:00;8;Vorarlberg;6686897;1270996;5415901
2022-03-04T09:30:00+01:00;9;Wien;51315931;43919550;7396381
2022-03-04T09:30:00+01:00;10;Österreich;161522349;73363128;88159221
2022-03-05T09:30:00+01:00;1;Burgenland;4654466;1262876;3391590
2022-03-05T09:30:00+01:00;2;Kärnten;6285287;1320569;4964718
2022-03-05T09:30:00+01:00;3;Niederösterreich;31639551;9850672;21788879
2022-03-05T09:30:00+01:00;4;Oberösterreich;22856087;5418431;17437656
2022-03-05T09:30:00+01:00;5;Salzburg;10116557;2665150;7451407
2022-03-05T09:30:00+01:00;6;Steiermark;19477458;4804235;14673223
2022-03-05T09:30:00+01:00;7;Tirol;8921682;3236583;5685099
2022-03-05T09:30:00+01:00;8;Vorarlberg;6697538;1277627;5419911
2022-03-05T09:30:00+01:00;9;Wien;51699358;44300051;7399307
2022-03-05T09:30:00+01:00;10;Österreich;162347984;74136194;88211790
2022-03-06T09:30:00+01:00;1;Burgenland;4668546;1272513;3396033
2022-03-06T09:30:00+01:00;2;Kärnten;6289437;1324719;4964718
2022-03-06T09:30:00+01:00;3;Niederösterreich;31674025;9879696;21794329
2022-03-06T09:30:00+01:00;4;Oberösterreich;22887087;5441771;17445316
2022-03-06T09:30:00+01:00;5;Salzburg;10128343;2675115;7453228
2022-03-06T09:30:00+01:00;6;Steiermark;19509297;4828842;14680455
2022-03-06T09:30:00+01:00;7;Tirol;8937273;3251090;5686183
2022-03-06T09:30:00+01:00;8;Vorarlberg;6705125;1283498;5421627
2022-03-06T09:30:00+01:00;9;Wien;51856896;44455269;7401627
2022-03-06T09:30:00+01:00;10;Österreich;162656029;74412513;88243516
2022-03-07T09:30:00+01:00;1;Burgenland;4679338;1281003;3398335
2022-03-07T09:30:00+01:00;2;Kärnten;6292674;1327595;4965079
2022-03-07T09:30:00+01:00;3;Niederösterreich;31712357;9912895;21799462
2022-03-07T09:30:00+01:00;4;Oberösterreich;22918100;5463659;17454441
2022-03-07T09:30:00+01:00;5;Salzburg;10137803;2684007;7453796
2022-03-07T09:30:00+01:00;6;Steiermark;19532189;4846444;14685745
2022-03-07T09:30:00+01:00;7;Tirol;8948601;3260675;5687926
2022-03-07T09:30:00+01:00;8;Vorarlberg;6713396;1289983;5423413
2022-03-07T09:30:00+01:00;9;Wien;51902717;44498279;7404438
2022-03-07T09:30:00+01:00;10;Österreich;162837175;74564540;88272635
2022-03-08T09:30:00+01:00;1;Burgenland;4695828;1286908;3408920
2022-03-08T09:30:00+01:00;2;Kärnten;6304144;1331356;4972788
2022-03-08T09:30:00+01:00;3;Niederösterreich;31781251;9946393;21834858
2022-03-08T09:30:00+01:00;4;Oberösterreich;22964919;5496147;17468772
2022-03-08T09:30:00+01:00;5;Salzburg;10154622;2693495;7461127
2022-03-08T09:30:00+01:00;6;Steiermark;19562982;4868797;14694185
2022-03-08T09:30:00+01:00;7;Tirol;8972263;3282901;5689362
2022-03-08T09:30:00+01:00;8;Vorarlberg;6723977;1297097;5426880
2022-03-08T09:30:00+01:00;9;Wien;52304630;44897229;7407401
2022-03-08T09:30:00+01:00;10;Österreich;163464616;75100323;88364293
2022-03-09T09:30:00+01:00;1;Burgenland;4706724;1294595;3412129
2022-03-09T09:30:00+01:00;2;Kärnten;6311359;1337718;4973641
2022-03-09T09:30:00+01:00;3;Niederösterreich;31885412;9973833;21911579
2022-03-09T09:30:00+01:00;4;Oberösterreich;23002676;5521866;17480810
2022-03-09T09:30:00+01:00;5;Salzburg;10167924;2704964;7462960
2022-03-09T09:30:00+01:00;6;Steiermark;19629565;4898209;14731356
2022-03-09T09:30:00+01:00;7;Tirol;8989988;3299393;5690595
2022-03-09T09:30:00+01:00;8;Vorarlberg;6734870;1304749;5430121
2022-03-09T09:30:00+01:00;9;Wien;52645283;45235318;7409965
2022-03-09T09:30:00+01:00;10;Österreich;164073801;75570645;88503156
2022-03-10T09:30:00+01:00;1;Burgenland;4720958;1305786;3415172
2022-03-10T09:30:00+01:00;2;Kärnten;6321600;1343527;4978073
2022-03-10T09:30:00+01:00;3;Niederösterreich;32207075;10011120;22195955
2022-03-10T09:30:00+01:00;4;Oberösterreich;23056771;5542917;17513854
2022-03-10T09:30:00+01:00;5;Salzburg;10180681;2715811;7464870
2022-03-10T09:30:00+01:00;6;Steiermark;19662740;4922632;14740108
2022-03-10T09:30:00+01:00;7;Tirol;9009009;3317149;5691860
2022-03-10T09:30:00+01:00;8;Vorarlberg;6743669;1310729;5432940
2022-03-10T09:30:00+01:00;9;Wien;52974412;45562270;7412142
2022-03-10T09:30:00+01:00;10;Österreich;164876915;76031941;88844974
2022-03-11T09:30:00+01:00;1;Burgenland;4732903;1314580;3418323
2022-03-11T09:30:00+01:00;2;Kärnten;6326357;1348284;4978073
2022-03-11T09:30:00+01:00;3;Niederösterreich;32238864;10035465;22203399
2022-03-11T09:30:00+01:00;4;Oberösterreich;23090450;5568741;17521709
2022-03-11T09:30:00+01:00;5;Salzburg;10195415;2728915;7466500
2022-03-11T09:30:00+01:00;6;Steiermark;19697947;4948451;14749496
2022-03-11T09:30:00+01:00;7;Tirol;9025508;3332543;5692965
2022-03-11T09:30:00+01:00;8;Vorarlberg;6755308;1319756;5435552
2022-03-11T09:30:00+01:00;9;Wien;53284695;45870289;7414406
2022-03-11T09:30:00+01:00;10;Österreich;165347447;76467024;88880423
2022-03-12T09:30:00+01:00;1;Burgenland;4760814;1326037;3434777
2022-03-12T09:30:00+01:00;2;Kärnten;6331997;1353924;4978073
2022-03-12T09:30:00+01:00;3;Niederösterreich;32514929;10302915;22212014
2022-03-12T09:30:00+01:00;4;Oberösterreich;23125285;5596212;17529073
2022-03-12T09:30:00+01:00;5;Salzburg;10207263;2739026;7468237
2022-03-12T09:30:00+01:00;6;Steiermark;19730085;4971389;14758696
2022-03-12T09:30:00+01:00;7;Tirol;9043292;3349273;5694019
2022-03-12T09:30:00+01:00;8;Vorarlberg;6765351;1327342;5438009
2022-03-12T09:30:00+01:00;9;Wien;53532619;46116418;7416201
2022-03-12T09:30:00+01:00;10;Österreich;166011635;77082536;88929099
2022-03-13T09:30:00+01:00;1;Burgenland;4769933;1333938;3435995
2022-03-13T09:30:00+01:00;2;Kärnten;6335180;1357107;4978073
2022-03-13T09:30:00+01:00;3;Niederösterreich;32552933;10337866;22215067
2022-03-13T09:30:00+01:00;4;Oberösterreich;23152452;5617758;17534694
2022-03-13T09:30:00+01:00;5;Salzburg;10218955;2749305;7469650
2022-03-13T09:30:00+01:00;6;Steiermark;19756262;4990498;14765764
2022-03-13T09:30:00+01:00;7;Tirol;9059300;3364213;5695087
2022-03-13T09:30:00+01:00;8;Vorarlberg;6773498;1333958;5439540
2022-03-13T09:30:00+01:00;9;Wien;53759794;46341932;7417862
2022-03-13T09:30:00+01:00;10;Österreich;166378307;77426575;88951732
2022-03-14T09:30:00+01:00;1;Burgenland;4780115;1342037;3438078
2022-03-14T09:30:00+01:00;2;Kärnten;6342402;1360107;4982295
2022-03-14T09:30:00+01:00;3;Niederösterreich;32582449;10364824;22217625
2022-03-14T09:30:00+01:00;4;Oberösterreich;23185145;5642320;17542825
2022-03-14T09:30:00+01:00;5;Salzburg;10226785;2756671;7470114
2022-03-14T09:30:00+01:00;6;Steiermark;19782498;5011481;14771017
2022-03-14T09:30:00+01:00;7;Tirol;9071965;3375196;5696769
2022-03-14T09:30:00+01:00;8;Vorarlberg;6782493;1341234;5441259
2022-03-14T09:30:00+01:00;9;Wien;53969738;46549455;7420283
2022-03-14T09:30:00+01:00;10;Österreich;166723590;77743325;88980265
2022-03-15T09:30:00+01:00;1;Burgenland;4793429;1351587;3441842
2022-03-15T09:30:00+01:00;2;Kärnten;6356459;1363512;4992947
2022-03-15T09:30:00+01:00;3;Niederösterreich;32643128;10396538;22246590
2022-03-15T09:30:00+01:00;4;Oberösterreich;23219191;5665765;17553426
2022-03-15T09:30:00+01:00;5;Salzburg;10262711;2764612;7498099
2022-03-15T09:30:00+01:00;6;Steiermark;19812777;5030960;14781817
2022-03-15T09:30:00+01:00;7;Tirol;9106530;3395001;5711529
2022-03-15T09:30:00+01:00;8;Vorarlberg;6793974;1349634;5444340
2022-03-15T09:30:00+01:00;9;Wien;54280070;46857246;7422824
2022-03-15T09:30:00+01:00;10;Österreich;167268269;78174855;89093414
2022-03-16T09:30:00+01:00;1;Burgenland;4801960;1357168;3444792
2022-03-16T09:30:00+01:00;2;Kärnten;6362424;1369264;4993160
2022-03-16T09:30:00+01:00;3;Niederösterreich;33210108;10682947;22527161
2022-03-16T09:30:00+01:00;4;Oberösterreich;23252699;5689704;17562995
2022-03-16T09:30:00+01:00;5;Salzburg;10279156;2779312;7499844
2022-03-16T09:30:00+01:00;6;Steiermark;19868149;5052260;14815889
2022-03-16T09:30:00+01:00;7;Tirol;9124558;3411971;5712587
2022-03-16T09:30:00+01:00;8;Vorarlberg;6806748;1359862;5446886
2022-03-16T09:30:00+01:00;9;Wien;54619617;47194768;7424849
2022-03-16T09:30:00+01:00;10;Österreich;168325419;78897256;89428163
2022-03-17T09:30:00+01:00;1;Burgenland;4815693;1367788;3447905
2022-03-17T09:30:00+01:00;2;Kärnten;6370886;1374432;4996454
2022-03-17T09:30:00+01:00;3;Niederösterreich;33521861;10720383;22801478
2022-03-17T09:30:00+01:00;4;Oberösterreich;23278596;5709492;17569104
2022-03-17T09:30:00+01:00;5;Salzburg;10293005;2791529;7501476
2022-03-17T09:30:00+01:00;6;Steiermark;19912776;5089115;14823661
2022-03-17T09:30:00+01:00;7;Tirol;9142175;3428439;5713736
2022-03-17T09:30:00+01:00;8;Vorarlberg;6818126;1368795;5449331
2022-03-17T09:30:00+01:00;9;Wien;54940896;47513982;7426914
2022-03-17T09:30:00+01:00;10;Österreich;169094014;79363955;89730059
2022-03-18T09:30:00+01:00;1;Burgenland;4825377;1374968;3450409
2022-03-18T09:30:00+01:00;2;Kärnten;6379050;1379441;4999609
2022-03-18T09:30:00+01:00;3;Niederösterreich;33555497;10748092;22807405
2022-03-18T09:30:00+01:00;4;Oberösterreich;23335348;5734229;17601119
2022-03-18T09:30:00+01:00;5;Salzburg;10306086;2803119;7502967
2022-03-18T09:30:00+01:00;6;Steiermark;19946415;5116231;14830184
2022-03-18T09:30:00+01:00;7;Tirol;9158131;3443283;5714848
2022-03-18T09:30:00+01:00;8;Vorarlberg;6828313;1376726;5451587
2022-03-18T09:30:00+01:00;9;Wien;55232056;47803346;7428710
2022-03-18T09:30:00+01:00;10;Österreich;169566273;79779435;89786838
2022-03-19T09:30:00+01:00;1;Burgenland;4858816;1392277;3466539
2022-03-19T09:30:00+01:00;2;Kärnten;6386876;1386010;5000866
2022-03-19T09:30:00+01:00;3;Niederösterreich;33807219;10991611;22815608
2022-03-19T09:30:00+01:00;4;Oberösterreich;23363570;5756955;17606615
2022-03-19T09:30:00+01:00;5;Salzburg;10315495;2811005;7504490
2022-03-19T09:30:00+01:00;6;Steiermark;19973728;5136512;14837216
2022-03-19T09:30:00+01:00;7;Tirol;9173573;3457774;5715799
2022-03-19T09:30:00+01:00;8;Vorarlberg;6838116;1384288;5453828
2022-03-19T09:30:00+01:00;9;Wien;55563807;48133227;7430580
2022-03-19T09:30:00+01:00;10;Österreich;170281200;80449659;89831541
2022-03-20T09:30:00+01:00;1;Burgenland;4869057;1401410;3467647
2022-03-20T09:30:00+01:00;2;Kärnten;6390259;1389393;5000866
2022-03-20T09:30:00+01:00;3;Niederösterreich;33840357;11021783;22818574
2022-03-20T09:30:00+01:00;4;Oberösterreich;23386323;5775912;17610411
2022-03-20T09:30:00+01:00;5;Salzburg;10324706;2819218;7505488
2022-03-20T09:30:00+01:00;6;Steiermark;20003431;5160589;14842842
2022-03-20T09:30:00+01:00;7;Tirol;9187552;3470732;5716820
2022-03-20T09:30:00+01:00;8;Vorarlberg;6845936;1390833;5455103
2022-03-20T09:30:00+01:00;9;Wien;55785608;48353494;7432114
2022-03-20T09:30:00+01:00;10;Österreich;170633229;80783364;89849865
2022-03-21T09:30:00+01:00;1;Burgenland;4880409;1411042;3469367
2022-03-21T09:30:00+01:00;2;Kärnten;6393285;1392033;5001252
2022-03-21T09:30:00+01:00;3;Niederösterreich;33876245;11055637;22820608
2022-03-21T09:30:00+01:00;4;Oberösterreich;23413213;5798258;17614955
2022-03-21T09:30:00+01:00;5;Salzburg;10333381;2827497;7505884
2022-03-21T09:30:00+01:00;6;Steiermark;20025723;5178518;14847205
2022-03-21T09:30:00+01:00;7;Tirol;9198806;3480581;5718225
2022-03-21T09:30:00+01:00;8;Vorarlberg;6854229;1397654;5456575
2022-03-21T09:30:00+01:00;9;Wien;55990511;48556068;7434443
2022-03-21T09:30:00+01:00;10;Österreich;170965802;81097288;89868514
2022-03-22T09:30:00+01:00;1;Burgenland;4892728;1420028;3472700
2022-03-22T09:30:00+01:00;2;Kärnten;6396801;1395549;5001252
2022-03-22T09:30:00+01:00;3;Niederösterreich;33940129;11090210;22849919
2022-03-22T09:30:00+01:00;4;Oberösterreich;23444183;5819503;17624680
2022-03-22T09:30:00+01:00;5;Salzburg;10347523;2837640;7509883
2022-03-22T09:30:00+01:00;6;Steiermark;20053254;5197668;14855586
2022-03-22T09:30:00+01:00;7;Tirol;9218153;3498694;5719459
2022-03-22T09:30:00+01:00;8;Vorarlberg;6864836;1405398;5459438
2022-03-22T09:30:00+01:00;9;Wien;56258318;48821376;7436942
2022-03-22T09:30:00+01:00;10;Österreich;171415925;81486066;89929859
2022-03-23T09:30:00+01:00;1;Burgenland;4903146;1427938;3475208
2022-03-23T09:30:00+01:00;2;Kärnten;6411330;1401145;5010185
2022-03-23T09:30:00+01:00;3;Niederösterreich;33989796;11122498;22867298
2022-03-23T09:30:00+01:00;4;Oberösterreich;23475218;5842029;17633189
2022-03-23T09:30:00+01:00;5;Salzburg;10363211;2851828;7511383
2022-03-23T09:30:00+01:00;6;Steiermark;20108448;5225549;14882899
2022-03-23T09:30:00+01:00;7;Tirol;9238608;3512472;5726136
2022-03-23T09:30:00+01:00;8;Vorarlberg;6876399;1414330;5462069
2022-03-23T09:30:00+01:00;9;Wien;56528088;49089300;7438788
2022-03-23T09:30:00+01:00;10;Österreich;171894244;81887089;90007155
2022-03-24T09:30:00+01:00;1;Burgenland;4917684;1440086;3477598
2022-03-24T09:30:00+01:00;2;Kärnten;6417616;1405377;5012239
2022-03-24T09:30:00+01:00;3;Niederösterreich;34280317;11157807;23122510
2022-03-24T09:30:00+01:00;4;Oberösterreich;23521776;5855759;17666017
2022-03-24T09:30:00+01:00;5;Salzburg;10372586;2859929;7512657
2022-03-24T09:30:00+01:00;6;Steiermark;20137237;5248644;14888593
2022-03-24T09:30:00+01:00;7;Tirol;9251815;3524806;5727009
2022-03-24T09:30:00+01:00;8;Vorarlberg;6886046;1421835;5464211
2022-03-24T09:30:00+01:00;9;Wien;56773050;49332360;7440690
2022-03-24T09:30:00+01:00;10;Österreich;172558127;82246603;90311524
2022-03-25T09:30:00+01:00;1;Burgenland;4928278;1448355;3479923
2022-03-25T09:30:00+01:00;2;Kärnten;6423688;1408931;5014757
2022-03-25T09:30:00+01:00;3;Niederösterreich;34313003;11182341;23130662
2022-03-25T09:30:00+01:00;4;Oberösterreich;23549696;5878219;17671477
2022-03-25T09:30:00+01:00;5;Salzburg;10385680;2871888;7513792
2022-03-25T09:30:00+01:00;6;Steiermark;20159840;5266057;14893783
2022-03-25T09:30:00+01:00;7;Tirol;9263953;3536024;5727929
2022-03-25T09:30:00+01:00;8;Vorarlberg;6894273;1427928;5466345
2022-03-25T09:30:00+01:00;9;Wien;56986441;49543858;7442583
2022-03-25T09:30:00+01:00;10;Österreich;172904852;82563601;90341251
2022-03-26T09:30:00+01:00;1;Burgenland;4942089;1456498;3485591
2022-03-26T09:30:00+01:00;2;Kärnten;6428982;1413272;5015710
2022-03-26T09:30:00+01:00;3;Niederösterreich;34589637;11338298;23251339
2022-03-26T09:30:00+01:00;4;Oberösterreich;23569943;5892702;17677241
2022-03-26T09:30:00+01:00;5;Salzburg;10395585;2880453;7515132
2022-03-26T09:30:00+01:00;6;Steiermark;20181228;5281718;14899510
2022-03-26T09:30:00+01:00;7;Tirol;9276486;3547682;5728804
2022-03-26T09:30:00+01:00;8;Vorarlberg;6903012;1434372;5468640
2022-03-26T09:30:00+01:00;9;Wien;57219997;49775546;7444451
2022-03-26T09:30:00+01:00;10;Österreich;173506959;83020541;90486418
2022-03-27T09:30:00+02:00;1;Burgenland;4951175;1464476;3486699
2022-03-27T09:30:00+02:00;2;Kärnten;6431488;1415778;5015710
2022-03-27T09:30:00+02:00;3;Niederösterreich;34621915;11368119;23253796
2022-03-27T09:30:00+02:00;4;Oberösterreich;23594268;5910951;17683317
2022-03-27T09:30:00+02:00;5;Salzburg;10401933;2885579;7516354
2022-03-27T09:30:00+02:00;6;Steiermark;20201551;5297176;14904375
2022-03-27T09:30:00+02:00;7;Tirol;9287770;3558109;5729661
2022-03-27T09:30:00+02:00;8;Vorarlberg;6909207;1438954;5470253
2022-03-27T09:30:00+02:00;9;Wien;57293731;49847857;7445874
2022-03-27T09:30:00+02:00;10;Österreich;173693038;83186999;90506039
2022-03-28T09:30:00+02:00;1;Burgenland;4959447;1471411;3488036
2022-03-28T09:30:00+02:00;2;Kärnten;6434490;1418780;5015710
2022-03-28T09:30:00+02:00;3;Niederösterreich;34650469;11394922;23255547
2022-03-28T09:30:00+02:00;4;Oberösterreich;23615060;5927559;17687501
2022-03-28T09:30:00+02:00;5;Salzburg;10407120;2890317;7516803
2022-03-28T09:30:00+02:00;6;Steiermark;20216084;5308765;14907319
2022-03-28T09:30:00+02:00;7;Tirol;9295726;3564963;5730763
2022-03-28T09:30:00+02:00;8;Vorarlberg;6915610;1444083;5471527
2022-03-28T09:30:00+02:00;9;Wien;57421128;49973164;7447964
2022-03-28T09:30:00+02:00;10;Österreich;173915134;83393964;90521170
2022-03-29T09:30:00+02:00;1;Burgenland;4968787;1477778;3491009
2022-03-29T09:30:00+02:00;2;Kärnten;6444006;1422836;5021170
2022-03-29T09:30:00+02:00;3;Niederösterreich;34812654;11426810;23385844
2022-03-29T09:30:00+02:00;4;Oberösterreich;23640629;5943410;17697219
2022-03-29T09:30:00+02:00;5;Salzburg;10418857;2897697;7521160
2022-03-29T09:30:00+02:00;6;Steiermark;20235795;5322913;14912882
2022-03-29T09:30:00+02:00;7;Tirol;9308825;3577117;5731708
2022-03-29T09:30:00+02:00;8;Vorarlberg;6923353;1449188;5474165
2022-03-29T09:30:00+02:00;9;Wien;57688663;50238483;7450180
2022-03-29T09:30:00+02:00;10;Österreich;174441569;83756232;90685337
2022-03-30T09:30:00+02:00;1;Burgenland;4978412;1485273;3493139
2022-03-30T09:30:00+02:00;2;Kärnten;6450039;1426278;5023761
2022-03-30T09:30:00+02:00;3;Niederösterreich;35294548;11760814;23533734
2022-03-30T09:30:00+02:00;4;Oberösterreich;23661944;5957472;17704472
2022-03-30T09:30:00+02:00;5;Salzburg;10429131;2906990;7522141
2022-03-30T09:30:00+02:00;6;Steiermark;20275774;5337811;14937963
2022-03-30T09:30:00+02:00;7;Tirol;9319455;3586991;5732464
2022-03-30T09:30:00+02:00;8;Vorarlberg;6930496;1454355;5476141
2022-03-30T09:30:00+02:00;9;Wien;57907581;50451208;7456373
2022-03-30T09:30:00+02:00;10;Österreich;175247380;84367192;90880188
2022-03-31T09:30:00+02:00;1;Burgenland;4987787;1492559;3495228
2022-03-31T09:30:00+02:00;2;Kärnten;6457038;1428388;5028650
2022-03-31T09:30:00+02:00;3;Niederösterreich;35328896;11790276;23538620
2022-03-31T09:30:00+02:00;4;Oberösterreich;23698936;5967446;17731490
2022-03-31T09:30:00+02:00;5;Salzburg;10437104;2913919;7523185
2022-03-31T09:30:00+02:00;6;Steiermark;20296100;5353655;14942445
2022-03-31T09:30:00+02:00;7;Tirol;9329084;3595864;5733220
2022-03-31T09:30:00+02:00;8;Vorarlberg;6936946;1458854;5478092
2022-03-31T09:30:00+02:00;9;Wien;58145396;50682731;7462665
2022-03-31T09:30:00+02:00;10;Österreich;175617287;84683692;90933595
2022-04-01T09:30:00+02:00;1;Burgenland;4997066;1499754;3497312
2022-04-01T09:30:00+02:00;2;Kärnten;6461076;1432426;5028650
2022-04-01T09:30:00+02:00;3;Niederösterreich;35588052;11813644;23774408
2022-04-01T09:30:00+02:00;4;Oberösterreich;23714720;5978851;17735869
2022-04-01T09:30:00+02:00;5;Salzburg;10445373;2921075;7524298
2022-04-01T09:30:00+02:00;6;Steiermark;20309642;5362398;14947244
2022-04-01T09:30:00+02:00;7;Tirol;9338646;3604728;5733918
2022-04-01T09:30:00+02:00;8;Vorarlberg;6942575;1462608;5479967
2022-04-01T09:30:00+02:00;9;Wien;58372512;50903633;7468879
2022-04-01T09:30:00+02:00;10;Österreich;176169662;84979117;91190545
2022-04-02T09:30:00+02:00;1;Burgenland;5006967;1508053;3498914
2022-04-02T09:30:00+02:00;2;Kärnten;6465189;1435804;5029385
2022-04-02T09:30:00+02:00;3;Niederösterreich;35818620;12040145;23778475
2022-04-02T09:30:00+02:00;4;Oberösterreich;23730500;5991417;17739083
2022-04-02T09:30:00+02:00;5;Salzburg;10451220;2926294;7524926
2022-04-02T09:30:00+02:00;6;Steiermark;20318900;5370785;14948115
2022-04-02T09:30:00+02:00;7;Tirol;9345231;3611313;5733918
2022-04-02T09:30:00+02:00;8;Vorarlberg;6946801;1465325;5481476
2022-04-02T09:30:00+02:00;9;Wien;58546572;51071293;7475279
2022-04-02T09:30:00+02:00;10;Österreich;176630000;85420429;91209571
2022-04-03T09:30:00+02:00;1;Burgenland;5011041;1511706;3499335
2022-04-03T09:30:00+02:00;2;Kärnten;6467203;1437818;5029385
2022-04-03T09:30:00+02:00;3;Niederösterreich;35856245;12068394;23787851
2022-04-03T09:30:00+02:00;4;Oberösterreich;23746530;6003582;17742948
2022-04-03T09:30:00+02:00;5;Salzburg;10455617;2929958;7525659
2022-04-03T09:30:00+02:00;6;Steiermark;20321345;5372164;14949181
2022-04-03T09:30:00+02:00;7;Tirol;9351225;3617307;5733918
2022-04-03T09:30:00+02:00;8;Vorarlberg;6950554;1468094;5482460
2022-04-03T09:30:00+02:00;9;Wien;58683870;51202285;7481585
2022-04-03T09:30:00+02:00;10;Österreich;176843630;85611308;91232322
2022-04-04T09:30:00+02:00;1;Burgenland;5014024;1514249;3499775
2022-04-04T09:30:00+02:00;2;Kärnten;6469307;1439922;5029385
2022-04-04T09:30:00+02:00;3;Niederösterreich;35881545;12089434;23792111
2022-04-04T09:30:00+02:00;4;Oberösterreich;23757403;6011851;17745552
2022-04-04T09:30:00+02:00;5;Salzburg;10458493;2932308;7526185
2022-04-04T09:30:00+02:00;6;Steiermark;20325091;5375180;14949911
2022-04-04T09:30:00+02:00;7;Tirol;9355038;3621120;5733918
2022-04-04T09:30:00+02:00;8;Vorarlberg;6954276;1470978;5483298
2022-04-04T09:30:00+02:00;9;Wien;58816499;51328225;7488274
2022-04-04T09:30:00+02:00;10;Österreich;177031676;85783267;91248409
2022-04-05T09:30:00+02:00;1;Burgenland;5019951;1518493;3501458
2022-04-05T09:30:00+02:00;2;Kärnten;6476526;1443063;5033463
2022-04-05T09:30:00+02:00;3;Niederösterreich;35924877;12115580;23809297
2022-04-05T09:30:00+02:00;4;Oberösterreich;23773165;6019371;17753794
2022-04-05T09:30:00+02:00;5;Salzburg;10462545;2937211;7525334
2022-04-05T09:30:00+02:00;6;Steiermark;20349370;5395959;14953411
2022-04-05T09:30:00+02:00;7;Tirol;9364662;3630744;5733918
2022-04-05T09:30:00+02:00;8;Vorarlberg;6958657;1473354;5485303
2022-04-05T09:30:00+02:00;9;Wien;59076246;51580686;7495560
2022-04-05T09:30:00+02:00;10;Österreich;177405999;86114461;91291538
2022-04-06T09:30:00+02:00;1;Burgenland;5027959;1525367;3502592
2022-04-06T09:30:00+02:00;2;Kärnten;6478957;1445494;5033463
2022-04-06T09:30:00+02:00;3;Niederösterreich;35956447;12137058;23819389
2022-04-06T09:30:00+02:00;4;Oberösterreich;23783645;6025705;17757940
2022-04-06T09:30:00+02:00;5;Salzburg;10467008;2941161;7525847
2022-04-06T09:30:00+02:00;6;Steiermark;20431748;5409722;15022026
2022-04-06T09:30:00+02:00;7;Tirol;9385146;3640312;5744834
2022-04-06T09:30:00+02:00;8;Vorarlberg;6963187;1476207;5486980
2022-04-06T09:30:00+02:00;9;Wien;59271312;51773689;7497623
2022-04-06T09:30:00+02:00;10;Österreich;177765409;86374715;91390694
2022-04-07T09:30:00+02:00;1;Burgenland;5036496;1532890;3503606
2022-04-07T09:30:00+02:00;2;Kärnten;6486392;1447991;5038401
2022-04-07T09:30:00+02:00;3;Niederösterreich;36367374;12239905;24127469
2022-04-07T09:30:00+02:00;4;Oberösterreich;23816208;6030651;17785557
2022-04-07T09:30:00+02:00;5;Salzburg;10471085;2944653;7526432
2022-04-07T09:30:00+02:00;6;Steiermark;20444540;5420943;15023597
2022-04-07T09:30:00+02:00;7;Tirol;9393458;3648624;5744834
2022-04-07T09:30:00+02:00;8;Vorarlberg;6967258;1478568;5488690
2022-04-07T09:30:00+02:00;9;Wien;59503618;52003791;7499827
2022-04-07T09:30:00+02:00;10;Österreich;178486429;86748016;91738413
2022-04-08T09:30:00+02:00;1;Burgenland;5041869;1537273;3504596
2022-04-08T09:30:00+02:00;2;Kärnten;6488391;1449990;5038401
2022-04-08T09:30:00+02:00;3;Niederösterreich;36387560;12257611;24129949
2022-04-08T09:30:00+02:00;4;Oberösterreich;23826623;6038704;17787919
2022-04-08T09:30:00+02:00;5;Salzburg;10474907;2947859;7527048
2022-04-08T09:30:00+02:00;6;Steiermark;20456881;5431788;15025093
2022-04-08T09:30:00+02:00;7;Tirol;9399448;3654614;5744834
2022-04-08T09:30:00+02:00;8;Vorarlberg;6970911;1480605;5490306
2022-04-08T09:30:00+02:00;9;Wien;59632358;52129138;7503220
2022-04-08T09:30:00+02:00;10;Österreich;178678948;86927582;91751366
2022-04-09T09:30:00+02:00;1;Burgenland;5051356;1543477;3507879
2022-04-09T09:30:00+02:00;2;Kärnten;6489938;1451496;5038442
2022-04-09T09:30:00+02:00;3;Niederösterreich;36726583;12476857;24249726
2022-04-09T09:30:00+02:00;4;Oberösterreich;23836125;6045211;17790914
2022-04-09T09:30:00+02:00;5;Salzburg;10478242;2950551;7527691
2022-04-09T09:30:00+02:00;6;Steiermark;20467815;5440953;15026862
2022-04-09T09:30:00+02:00;7;Tirol;9404546;3659712;5744834
2022-04-09T09:30:00+02:00;8;Vorarlberg;6974653;1482668;5491985
2022-04-09T09:30:00+02:00;9;Wien;59766035;52259628;7506407
2022-04-09T09:30:00+02:00;10;Österreich;179195293;87310553;91884740
2022-04-10T09:30:00+02:00;1;Burgenland;5055655;1547400;3508255
2022-04-10T09:30:00+02:00;2;Kärnten;6493552;1452779;5040773
2022-04-10T09:30:00+02:00;3;Niederösterreich;36742904;12491922;24250982
2022-04-10T09:30:00+02:00;4;Oberösterreich;23845939;6051396;17794543
2022-04-10T09:30:00+02:00;5;Salzburg;10481328;2952868;7528460
2022-04-10T09:30:00+02:00;6;Steiermark;20480125;5451651;15028474
2022-04-10T09:30:00+02:00;7;Tirol;9408928;3664094;5744834
2022-04-10T09:30:00+02:00;8;Vorarlberg;6977640;1484533;5493107
2022-04-10T09:30:00+02:00;9;Wien;59879684;52370398;7509286
2022-04-10T09:30:00+02:00;10;Österreich;179365755;87467041;91898714
2022-04-11T09:30:00+02:00;1;Burgenland;5059645;1551177;3508468
2022-04-11T09:30:00+02:00;2;Kärnten;6495086;1454201;5040885
2022-04-11T09:30:00+02:00;3;Niederösterreich;36757348;12505653;24251695
2022-04-11T09:30:00+02:00;4;Oberösterreich;23852590;6055636;17796954
2022-04-11T09:30:00+02:00;5;Salzburg;10483628;2954723;7528905
2022-04-11T09:30:00+02:00;6;Steiermark;20483667;5454421;15029246
2022-04-11T09:30:00+02:00;7;Tirol;9411351;3666517;5744834
2022-04-11T09:30:00+02:00;8;Vorarlberg;6980415;1486345;5494070
2022-04-11T09:30:00+02:00;9;Wien;59942102;52429994;7512108
2022-04-11T09:30:00+02:00;10;Österreich;179465832;87558667;91907165
2022-04-12T09:30:00+02:00;1;Burgenland;5061737;1552287;3509450
2022-04-12T09:30:00+02:00;2;Kärnten;6499434;1456609;5042825
2022-04-12T09:30:00+02:00;3;Niederösterreich;36777411;12521809;24255602
2022-04-12T09:30:00+02:00;4;Oberösterreich;23924081;6061862;17862219
2022-04-12T09:30:00+02:00;5;Salzburg;10486997;2957789;7529208
2022-04-12T09:30:00+02:00;6;Steiermark;20490220;5459284;15030936
2022-04-12T09:30:00+02:00;7;Tirol;9417268;3672434;5744834
2022-04-12T09:30:00+02:00;8;Vorarlberg;6983678;1487814;5495864
2022-04-12T09:30:00+02:00;9;Wien;60026534;52511459;7515075
2022-04-12T09:30:00+02:00;10;Österreich;179667360;87681347;91986013
2022-04-13T09:30:00+02:00;1;Burgenland;5067417;1557094;3510323
2022-04-13T09:30:00+02:00;2;Kärnten;6504141;1458230;5045911
2022-04-13T09:30:00+02:00;3;Niederösterreich;36795949;12537299;24258650
2022-04-13T09:30:00+02:00;4;Oberösterreich;23933679;6066070;17867609
2022-04-13T09:30:00+02:00;5;Salzburg;10490213;2960457;7529756
2022-04-13T09:30:00+02:00;6;Steiermark;20520780;5470368;15050412
2022-04-13T09:30:00+02:00;7;Tirol;9421562;3676728;5744834
2022-04-13T09:30:00+02:00;8;Vorarlberg;6987006;1489787;5497219
2022-04-13T09:30:00+02:00;9;Wien;60132565;52614904;7517661
2022-04-13T09:30:00+02:00;10;Österreich;179853312;87830937;92022375
2022-04-14T09:30:00+02:00;1;Burgenland;5073181;1562227;3510954
2022-04-14T09:30:00+02:00;2;Kärnten;6506919;1460120;5046799
2022-04-14T09:30:00+02:00;3;Niederösterreich;36915253;12551969;24363284
2022-04-14T09:30:00+02:00;4;Oberösterreich;23959271;6070438;17888833
2022-04-14T09:30:00+02:00;5;Salzburg;10493197;2962924;7530273
2022-04-14T09:30:00+02:00;6;Steiermark;20529702;5477928;15051774
2022-04-14T09:30:00+02:00;7;Tirol;9425870;3681036;5744834
2022-04-14T09:30:00+02:00;8;Vorarlberg;6989982;1491319;5498663
2022-04-14T09:30:00+02:00;9;Wien;60222322;52702247;7520075
2022-04-14T09:30:00+02:00;10;Österreich;180115697;87960208;92155489
2022-04-15T09:30:00+02:00;1;Burgenland;5076783;1565266;3511517
2022-04-15T09:30:00+02:00;2;Kärnten;6508693;1461628;5047065
2022-04-15T09:30:00+02:00;3;Niederösterreich;36929021;12563041;24365980
2022-04-15T09:30:00+02:00;4;Oberösterreich;23966620;6075994;17890626
2022-04-15T09:30:00+02:00;5;Salzburg;10496102;2965316;7530786
2022-04-15T09:30:00+02:00;6;Steiermark;20539158;5486133;15053025
2022-04-15T09:30:00+02:00;7;Tirol;9429665;3684831;5744834
2022-04-15T09:30:00+02:00;8;Vorarlberg;6992622;1492725;5499897
2022-04-15T09:30:00+02:00;9;Wien;60306678;52784867;7521811
2022-04-15T09:30:00+02:00;10;Österreich;180245342;88079801;92165541
2022-04-16T09:30:00+02:00;1;Burgenland;5078787;1566397;3512390
2022-04-16T09:30:00+02:00;2;Kärnten;6510219;1463140;5047079
2022-04-16T09:30:00+02:00;3;Niederösterreich;37050326;12630790;24419536
2022-04-16T09:30:00+02:00;4;Oberösterreich;23972845;6080336;17892509
2022-04-16T09:30:00+02:00;5;Salzburg;10499094;2967878;7531216
2022-04-16T09:30:00+02:00;6;Steiermark;20548514;5494219;15054295
2022-04-16T09:30:00+02:00;7;Tirol;9433563;3688729;5744834
2022-04-16T09:30:00+02:00;8;Vorarlberg;6994897;1493982;5500915
2022-04-16T09:30:00+02:00;9;Wien;60383700;52860268;7523432
2022-04-16T09:30:00+02:00;10;Österreich;180471945;88245739;92226206
2022-04-17T09:30:00+02:00;1;Burgenland;5084838;1572321;3512517
2022-04-17T09:30:00+02:00;2;Kärnten;6510880;1463801;5047079
2022-04-17T09:30:00+02:00;3;Niederösterreich;37061076;12641096;24419980
2022-04-17T09:30:00+02:00;4;Oberösterreich;23978414;6084504;17893910
2022-04-17T09:30:00+02:00;5;Salzburg;10501617;2969990;7531627
2022-04-17T09:30:00+02:00;6;Steiermark;20558143;5503043;15055100
2022-04-17T09:30:00+02:00;7;Tirol;9436985;3692151;5744834
2022-04-17T09:30:00+02:00;8;Vorarlberg;6996893;1495378;5501515
2022-04-17T09:30:00+02:00;9;Wien;60449316;52924300;7525016
2022-04-17T09:30:00+02:00;10;Österreich;180578162;88346584;92231578
2022-04-18T09:30:00+02:00;1;Burgenland;5088442;1575584;3512858
2022-04-18T09:30:00+02:00;2;Kärnten;6511412;1464333;5047079
2022-04-18T09:30:00+02:00;3;Niederösterreich;37069614;12649189;24420425
2022-04-18T09:30:00+02:00;4;Oberösterreich;23984049;6088427;17895622
2022-04-18T09:30:00+02:00;5;Salzburg;10503285;2971246;7532039
2022-04-18T09:30:00+02:00;6;Steiermark;20561157;5505419;15055738
2022-04-18T09:30:00+02:00;7;Tirol;9438678;3693844;5744834
2022-04-18T09:30:00+02:00;8;Vorarlberg;6998698;1496644;5502054
2022-04-18T09:30:00+02:00;9;Wien;60502599;52975918;7526681
2022-04-18T09:30:00+02:00;10;Österreich;180657934;88420604;92237330
2022-04-19T09:30:00+02:00;1;Burgenland;5090456;1577339;3513117
2022-04-19T09:30:00+02:00;2;Kärnten;6512585;1465506;5047079
2022-04-19T09:30:00+02:00;3;Niederösterreich;37078182;12657282;24420900
2022-04-19T09:30:00+02:00;4;Oberösterreich;23991410;6093174;17898236
2022-04-19T09:30:00+02:00;5;Salzburg;10505154;2972628;7532526
2022-04-19T09:30:00+02:00;6;Steiermark;20566463;5509728;15056735
2022-04-19T09:30:00+02:00;7;Tirol;9440846;3696012;5744834
2022-04-19T09:30:00+02:00;8;Vorarlberg;7000402;1497522;5502880
2022-04-19T09:30:00+02:00;9;Wien;60574346;53045442;7528904
2022-04-19T09:30:00+02:00;10;Österreich;180759844;88514633;92245211
2022-04-20T09:30:00+02:00;1;Burgenland;5093745;1579960;3513785
2022-04-20T09:30:00+02:00;2;Kärnten;6518260;1467830;5050430
2022-04-20T09:30:00+02:00;3;Niederösterreich;37098722;12669242;24429480
2022-04-20T09:30:00+02:00;4;Oberösterreich;24002901;6097545;17905356
2022-04-20T09:30:00+02:00;5;Salzburg;10508889;2975679;7533210
2022-04-20T09:30:00+02:00;6;Steiermark;20583230;5515805;15067425
2022-04-20T09:30:00+02:00;7;Tirol;9445864;3701030;5744834
2022-04-20T09:30:00+02:00;8;Vorarlberg;7003185;1498447;5504738
2022-04-20T09:30:00+02:00;9;Wien;60753001;53222153;7530848
2022-04-20T09:30:00+02:00;10;Österreich;181007797;88727691;92280106
2022-04-21T09:30:00+02:00;1;Burgenland;5103592;1587666;3515926
2022-04-21T09:30:00+02:00;2;Kärnten;6524096;1470006;5054090
2022-04-21T09:30:00+02:00;3;Niederösterreich;37219322;12727357;24491965
2022-04-21T09:30:00+02:00;4;Oberösterreich;24022269;6100328;17921941
2022-04-21T09:30:00+02:00;5;Salzburg;10511659;2978003;7533656
2022-04-21T09:30:00+02:00;6;Steiermark;20594417;5525604;15068813
2022-04-21T09:30:00+02:00;7;Tirol;9449715;3704881;5744834
2022-04-21T09:30:00+02:00;8;Vorarlberg;7006195;1500092;5506103
2022-04-21T09:30:00+02:00;9;Wien;60920825;53389015;7531810
2022-04-21T09:30:00+02:00;10;Österreich;181352090;88982952;92369138
2022-04-22T09:30:00+02:00;1;Burgenland;5107503;1591121;3516382
2022-04-22T09:30:00+02:00;2;Kärnten;6525667;1471364;5054303
2022-04-22T09:30:00+02:00;3;Niederösterreich;37342949;12845654;24497295
2022-04-22T09:30:00+02:00;4;Oberösterreich;24028468;6104798;17923670
2022-04-22T09:30:00+02:00;5;Salzburg;10514044;2979976;7534068
2022-04-22T09:30:00+02:00;6;Steiermark;20603530;5533504;15070026
2022-04-22T09:30:00+02:00;7;Tirol;9452915;3708081;5744834
2022-04-22T09:30:00+02:00;8;Vorarlberg;7008586;1501063;5507523
2022-04-22T09:30:00+02:00;9;Wien;61027430;53494765;7532665
2022-04-22T09:30:00+02:00;10;Österreich;181611092;89230326;92380766
2022-04-23T09:30:00+02:00;1;Burgenland;5112133;1594876;3517257
2022-04-23T09:30:00+02:00;2;Kärnten;6526910;1472397;5054513
2022-04-23T09:30:00+02:00;3;Niederösterreich;37355298;12854730;24500568
2022-04-23T09:30:00+02:00;4;Oberösterreich;24034483;6109047;17925436
2022-04-23T09:30:00+02:00;5;Salzburg;10516294;2981804;7534490
2022-04-23T09:30:00+02:00;6;Steiermark;20611051;5539851;15071200
2022-04-23T09:30:00+02:00;7;Tirol;9456058;3711224;5744834
2022-04-23T09:30:00+02:00;8;Vorarlberg;7010916;1502205;5508711
2022-04-23T09:30:00+02:00;9;Wien;61101167;53567534;7533633
2022-04-23T09:30:00+02:00;10;Österreich;181724310;89333668;92390642
2022-04-24T09:30:00+02:00;1;Burgenland;5115391;1597873;3517518
2022-04-24T09:30:00+02:00;2;Kärnten;6527677;1473146;5054531
2022-04-24T09:30:00+02:00;3;Niederösterreich;37366953;12865949;24501004
2022-04-24T09:30:00+02:00;4;Oberösterreich;24039624;6112649;17926975
2022-04-24T09:30:00+02:00;5;Salzburg;10518162;2983362;7534800
2022-04-24T09:30:00+02:00;6;Steiermark;20618075;5546204;15071871
2022-04-24T09:30:00+02:00;7;Tirol;9458613;3713779;5744834
2022-04-24T09:30:00+02:00;8;Vorarlberg;7012055;1502861;5509194
2022-04-24T09:30:00+02:00;9;Wien;61169184;53634866;7534318
2022-04-24T09:30:00+02:00;10;Österreich;181825734;89430689;92395045
2022-04-25T09:30:00+02:00;1;Burgenland;5118684;1601027;3517657
2022-04-25T09:30:00+02:00;2;Kärnten;6528737;1474110;5054627
2022-04-25T09:30:00+02:00;3;Niederösterreich;37374565;12873206;24501359
2022-04-25T09:30:00+02:00;4;Oberösterreich;24044431;6116154;17928277
2022-04-25T09:30:00+02:00;5;Salzburg;10519126;2984004;7535122
2022-04-25T09:30:00+02:00;6;Steiermark;20620990;5548497;15072493
2022-04-25T09:30:00+02:00;7;Tirol;9460284;3715450;5744834
2022-04-25T09:30:00+02:00;8;Vorarlberg;7013417;1503617;5509800
2022-04-25T09:30:00+02:00;9;Wien;61230227;53695052;7535175
2022-04-25T09:30:00+02:00;10;Österreich;181910461;89511117;92399344
2022-04-26T09:30:00+02:00;1;Burgenland;5121074;1602646;3518428
2022-04-26T09:30:00+02:00;2;Kärnten;6532664;1475876;5056788
2022-04-26T09:30:00+02:00;3;Niederösterreich;37470334;12882605;24587729
2022-04-26T09:30:00+02:00;4;Oberösterreich;24055624;6120592;17935032
2022-04-26T09:30:00+02:00;5;Salzburg;10522737;2987050;7535687
2022-04-26T09:30:00+02:00;6;Steiermark;20627442;5553419;15074023
2022-04-26T09:30:00+02:00;7;Tirol;9464662;3719828;5744834
2022-04-26T09:30:00+02:00;8;Vorarlberg;7016261;1504845;5511416
2022-04-26T09:30:00+02:00;9;Wien;61368745;53832380;7536365
2022-04-26T09:30:00+02:00;10;Österreich;182179543;89679241;92500302
2022-04-27T09:30:00+02:00;1;Burgenland;5125684;1606690;3518994
2022-04-27T09:30:00+02:00;2;Kärnten;6534553;1477285;5057268
2022-04-27T09:30:00+02:00;3;Niederösterreich;37488396;12894048;24594348
2022-04-27T09:30:00+02:00;4;Oberösterreich;24061590;6123625;17937965
2022-04-27T09:30:00+02:00;5;Salzburg;10525179;2989034;7536145
2022-04-27T09:30:00+02:00;6;Steiermark;20656297;5562771;15093526
2022-04-27T09:30:00+02:00;7;Tirol;9467945;3723111;5744834
2022-04-27T09:30:00+02:00;8;Vorarlberg;7018642;1505852;5512790
2022-04-27T09:30:00+02:00;9;Wien;61538112;54000916;7537196
2022-04-27T09:30:00+02:00;10;Österreich;182416398;89883332;92533066
2022-04-28T09:30:00+02:00;1;Burgenland;5130895;1611507;3519388
2022-04-28T09:30:00+02:00;2;Kärnten;6538539;1478808;5059731
2022-04-28T09:30:00+02:00;3;Niederösterreich;37497926;12902590;24595336
2022-04-28T09:30:00+02:00;4;Oberösterreich;24084660;6126660;17958000
2022-04-28T09:30:00+02:00;5;Salzburg;10527404;2990831;7536573
2022-04-28T09:30:00+02:00;6;Steiermark;20664103;5569286;15094817
2022-04-28T09:30:00+02:00;7;Tirol;9470950;3726116;5744834
2022-04-28T09:30:00+02:00;8;Vorarlberg;7020706;1506692;5514014
2022-04-28T09:30:00+02:00;9;Wien;61661060;54122942;7538118
2022-04-28T09:30:00+02:00;10;Österreich;182596243;90035432;92560811
2022-04-29T09:30:00+02:00;1;Burgenland;5134010;1614253;3519757
2022-04-29T09:30:00+02:00;2;Kärnten;6539873;1480121;5059752
2022-04-29T09:30:00+02:00;3;Niederösterreich;37620099;13023874;24596225
2022-04-29T09:30:00+02:00;4;Oberösterreich;24090610;6130968;17959642
2022-04-29T09:30:00+02:00;5;Salzburg;10529754;2992703;7537051
2022-04-29T09:30:00+02:00;6;Steiermark;20672903;5576904;15095999
2022-04-29T09:30:00+02:00;7;Tirol;9473609;3728775;5744834
2022-04-29T09:30:00+02:00;8;Vorarlberg;7022811;1507574;5515237
2022-04-29T09:30:00+02:00;9;Wien;61758717;54219779;7538938
2022-04-29T09:30:00+02:00;10;Österreich;182842386;90274951;92567435
2022-04-30T09:30:00+02:00;1;Burgenland;5138598;1617161;3521437
2022-04-30T09:30:00+02:00;2;Kärnten;6540770;1480954;5059816
2022-04-30T09:30:00+02:00;3;Niederösterreich;37673357;13074377;24598980
2022-04-30T09:30:00+02:00;4;Oberösterreich;24096035;6134952;17961083
2022-04-30T09:30:00+02:00;5;Salzburg;10531594;2994128;7537466
2022-04-30T09:30:00+02:00;6;Steiermark;20679408;5582317;15097091
2022-04-30T09:30:00+02:00;7;Tirol;9476252;3731418;5744834
2022-04-30T09:30:00+02:00;8;Vorarlberg;7024753;1508340;5516413
2022-04-30T09:30:00+02:00;9;Wien;61841676;54301874;7539802
2022-04-30T09:30:00+02:00;10;Österreich;183002443;90425521;92576922
2022-05-01T09:30:00+02:00;1;Burgenland;5141625;1619871;3521754
2022-05-01T09:30:00+02:00;2;Kärnten;6541529;1481700;5059829
2022-05-01T09:30:00+02:00;3;Niederösterreich;37682538;13082693;24599845
2022-05-01T09:30:00+02:00;4;Oberösterreich;24100420;6138099;17962321
2022-05-01T09:30:00+02:00;5;Salzburg;10533244;2995309;7537935
2022-05-01T09:30:00+02:00;6;Steiermark;20686065;5588379;15097686
2022-05-01T09:30:00+02:00;7;Tirol;9478791;3733957;5744834
2022-05-01T09:30:00+02:00;8;Vorarlberg;7025754;1508886;5516868
2022-05-01T09:30:00+02:00;9;Wien;61896191;54355617;7540574
2022-05-01T09:30:00+02:00;10;Österreich;183086157;90504511;92581646
2022-05-02T09:30:00+02:00;1;Burgenland;5144173;1622284;3521889
2022-05-02T09:30:00+02:00;2;Kärnten;6542587;1482646;5059941
2022-05-02T09:30:00+02:00;3;Niederösterreich;37689625;13088930;24600695
2022-05-02T09:30:00+02:00;4;Oberösterreich;24104701;6141066;17963635
2022-05-02T09:30:00+02:00;5;Salzburg;10534693;2996439;7538254
2022-05-02T09:30:00+02:00;6;Steiermark;20688873;5590562;15098311
2022-05-02T09:30:00+02:00;7;Tirol;9480154;3735320;5744834
2022-05-02T09:30:00+02:00;8;Vorarlberg;7027056;1509535;5517521
2022-05-02T09:30:00+02:00;9;Wien;61945915;54404596;7541319
2022-05-02T09:30:00+02:00;10;Österreich;183157777;90571378;92586399
2022-05-03T09:30:00+02:00;1;Burgenland;5146590;1624013;3522577
2022-05-03T09:30:00+02:00;2;Kärnten;6549399;1484343;5065056
2022-05-03T09:30:00+02:00;3;Niederösterreich;37699064;13095750;24603314
2022-05-03T09:30:00+02:00;4;Oberösterreich;24113354;6145140;17968214
2022-05-03T09:30:00+02:00;5;Salzburg;10537215;2998322;7538893
2022-05-03T09:30:00+02:00;6;Steiermark;20695501;5595463;15100038
2022-05-03T09:30:00+02:00;7;Tirol;9484141;3739307;5744834
2022-05-03T09:30:00+02:00;8;Vorarlberg;7029376;1510314;5519062
2022-05-03T09:30:00+02:00;9;Wien;62067249;54525290;7541959
2022-05-03T09:30:00+02:00;10;Österreich;183321889;90717942;92603947
2022-05-04T09:30:00+02:00;1;Burgenland;5150596;1627756;3522840
2022-05-04T09:30:00+02:00;2;Kärnten;6550765;1485373;5065392
2022-05-04T09:30:00+02:00;3;Niederösterreich;37713121;13104442;24608679
2022-05-04T09:30:00+02:00;4;Oberösterreich;24121590;6148412;17973178
2022-05-04T09:30:00+02:00;5;Salzburg;10539900;3000526;7539374
2022-05-04T09:30:00+02:00;6;Steiermark;20717785;5602788;15114997
2022-05-04T09:30:00+02:00;7;Tirol;9486944;3742110;5744834
2022-05-04T09:30:00+02:00;8;Vorarlberg;7031841;1511318;5520523
2022-05-04T09:30:00+02:00;9;Wien;62210138;54665322;7544816
2022-05-04T09:30:00+02:00;10;Österreich;183522680;90888047;92634633
2022-05-05T09:30:00+02:00;1;Burgenland;5155425;1632128;3523297
2022-05-05T09:30:00+02:00;2;Kärnten;6552307;1486699;5065608
2022-05-05T09:30:00+02:00;3;Niederösterreich;37720865;13110483;24610382
2022-05-05T09:30:00+02:00;4;Oberösterreich;24142540;6150812;17991728
2022-05-05T09:30:00+02:00;5;Salzburg;10542022;3002227;7539795
2022-05-05T09:30:00+02:00;6;Steiermark;20724431;5608175;15116256
2022-05-05T09:30:00+02:00;7;Tirol;9489782;3744948;5744834
2022-05-05T09:30:00+02:00;8;Vorarlberg;7033519;1512063;5521456
2022-05-05T09:30:00+02:00;9;Wien;62321998;54774452;7547546
2022-05-05T09:30:00+02:00;10;Österreich;183682889;91021987;92660902
2022-05-06T09:30:00+02:00;1;Burgenland;5158426;1634876;3523550
2022-05-06T09:30:00+02:00;2;Kärnten;6554271;1487668;5066603
2022-05-06T09:30:00+02:00;3;Niederösterreich;37891034;13276960;24614074
2022-05-06T09:30:00+02:00;4;Oberösterreich;24148608;6155180;17993428
2022-05-06T09:30:00+02:00;5;Salzburg;10544005;3003746;7540259
2022-05-06T09:30:00+02:00;6;Steiermark;20732103;5614650;15117453
2022-05-06T09:30:00+02:00;7;Tirol;9492210;3747376;5744834
2022-05-06T09:30:00+02:00;8;Vorarlberg;7034953;1512818;5522135
2022-05-06T09:30:00+02:00;9;Wien;62413688;54863389;7550299
2022-05-06T09:30:00+02:00;10;Österreich;183969298;91296663;92672635
2022-05-07T09:30:00+02:00;1;Burgenland;5163282;1637580;3525702
2022-05-07T09:30:00+02:00;2;Kärnten;6555939;1488506;5067433
2022-05-07T09:30:00+02:00;3;Niederösterreich;37900336;13284606;24615730
2022-05-07T09:30:00+02:00;4;Oberösterreich;24153034;6158173;17994861
2022-05-07T09:30:00+02:00;5;Salzburg;10545726;3005042;7540684
2022-05-07T09:30:00+02:00;6;Steiermark;20738195;5619685;15118510
2022-05-07T09:30:00+02:00;7;Tirol;9494665;3749831;5744834
2022-05-07T09:30:00+02:00;8;Vorarlberg;7036049;1513343;5522706
2022-05-07T09:30:00+02:00;9;Wien;62482170;54929171;7552999
2022-05-07T09:30:00+02:00;10;Österreich;184069396;91385937;92683459
2022-05-08T09:30:00+02:00;1;Burgenland;5166014;1640150;3525864
2022-05-08T09:30:00+02:00;2;Kärnten;6556614;1489181;5067433
2022-05-08T09:30:00+02:00;3;Niederösterreich;37907448;13291438;24616010
2022-05-08T09:30:00+02:00;4;Oberösterreich;24156379;6160547;17995832
2022-05-08T09:30:00+02:00;5;Salzburg;10547093;3006082;7541011
2022-05-08T09:30:00+02:00;6;Steiermark;20743460;5624373;15119087
2022-05-08T09:30:00+02:00;7;Tirol;9496823;3751989;5744834
2022-05-08T09:30:00+02:00;8;Vorarlberg;7036823;1513889;5522934
2022-05-08T09:30:00+02:00;9;Wien;62536438;54980758;7555680
2022-05-08T09:30:00+02:00;10;Österreich;184147092;91458407;92688685
2022-05-09T09:30:00+02:00;1;Burgenland;5168272;1642408;3525864
2022-05-09T09:30:00+02:00;2;Kärnten;6557706;1490271;5067435
2022-05-09T09:30:00+02:00;3;Niederösterreich;37912128;13295823;24616305
2022-05-09T09:30:00+02:00;4;Oberösterreich;24159465;6163246;17996219
2022-05-09T09:30:00+02:00;5;Salzburg;10548254;3006905;7541349
2022-05-09T09:30:00+02:00;6;Steiermark;20746627;5626957;15119670
2022-05-09T09:30:00+02:00;7;Tirol;9498028;3753194;5744834
2022-05-09T09:30:00+02:00;8;Vorarlberg;7037581;1514406;5523175
2022-05-09T09:30:00+02:00;9;Wien;62587335;55028826;7558509
2022-05-09T09:30:00+02:00;10;Österreich;184215396;91522036;92693360
2022-05-10T09:30:00+02:00;1;Burgenland;5170213;1643949;3526264
2022-05-10T09:30:00+02:00;2;Kärnten;6559444;1491661;5067783
2022-05-10T09:30:00+02:00;3;Niederösterreich;37920800;13302931;24617869
2022-05-10T09:30:00+02:00;4;Oberösterreich;24167213;6167001;18000212
2022-05-10T09:30:00+02:00;5;Salzburg;10550943;3008998;7541945
2022-05-10T09:30:00+02:00;6;Steiermark;20753269;5632090;15121179
2022-05-10T09:30:00+02:00;7;Tirol;9501411;3756577;5744834
2022-05-10T09:30:00+02:00;8;Vorarlberg;7039046;1515105;5523941
2022-05-10T09:30:00+02:00;9;Wien;62725843;55164511;7561332
2022-05-10T09:30:00+02:00;10;Österreich;184388182;91682823;92705359
2022-05-11T09:30:00+02:00;1;Burgenland;5175049;1648247;3526802
2022-05-11T09:30:00+02:00;2;Kärnten;6565840;1492940;5072900
2022-05-11T09:30:00+02:00;3;Niederösterreich;37931476;13312200;24619276
2022-05-11T09:30:00+02:00;4;Oberösterreich;24171661;6169337;18002324
2022-05-11T09:30:00+02:00;5;Salzburg;10552718;3010411;7542307
2022-05-11T09:30:00+02:00;6;Steiermark;20813389;5638476;15174913
2022-05-11T09:30:00+02:00;7;Tirol;9504032;3759198;5744834
2022-05-11T09:30:00+02:00;8;Vorarlberg;7040434;1515853;5524581
2022-05-11T09:30:00+02:00;9;Wien;62862503;55299939;7562564
2022-05-11T09:30:00+02:00;10;Österreich;184617102;91846601;92770501
2022-05-12T09:30:00+02:00;1;Burgenland;5179199;1652089;3527110
2022-05-12T09:30:00+02:00;2;Kärnten;6567277;1494177;5073100
2022-05-12T09:30:00+02:00;3;Niederösterreich;37940328;13319649;24620679
2022-05-12T09:30:00+02:00;4;Oberösterreich;24188284;6171746;18016538
2022-05-12T09:30:00+02:00;5;Salzburg;10554646;3012016;7542630
2022-05-12T09:30:00+02:00;6;Steiermark;20829064;5644144;15184920
2022-05-12T09:30:00+02:00;7;Tirol;9506505;3761671;5744834
2022-05-12T09:30:00+02:00;8;Vorarlberg;7041764;1516537;5525227
2022-05-12T09:30:00+02:00;9;Wien;62958433;55394651;7563782
2022-05-12T09:30:00+02:00;10;Österreich;184765500;91966680;92798820
2022-05-13T09:30:00+02:00;1;Burgenland;5182207;1654736;3527471
2022-05-13T09:30:00+02:00;2;Kärnten;6568225;1494896;5073329
2022-05-13T09:30:00+02:00;3;Niederösterreich;37947266;13325154;24622112
2022-05-13T09:30:00+02:00;4;Oberösterreich;24196199;6175121;18021078
2022-05-13T09:30:00+02:00;5;Salzburg;10556448;3013445;7543003
2022-05-13T09:30:00+02:00;6;Steiermark;20835296;5649237;15186059
2022-05-13T09:30:00+02:00;7;Tirol;9508622;3763788;5744834
2022-05-13T09:30:00+02:00;8;Vorarlberg;7041764;1516537;5525227
2022-05-13T09:30:00+02:00;9;Wien;63038671;55473686;7564985
2022-05-13T09:30:00+02:00;10;Österreich;184874698;92066600;92808098
2022-05-14T09:30:00+02:00;1;Burgenland;5185492;1657373;3528119
2022-05-14T09:30:00+02:00;2;Kärnten;6568878;1495476;5073402
2022-05-14T09:30:00+02:00;3;Niederösterreich;37954720;13331283;24623437
2022-05-14T09:30:00+02:00;4;Oberösterreich;24200272;6177875;18022397
2022-05-14T09:30:00+02:00;5;Salzburg;10557960;3014626;7543334
2022-05-14T09:30:00+02:00;6;Steiermark;20841561;5654625;15186936
2022-05-14T09:30:00+02:00;7;Tirol;9510807;3765973;5744834
2022-05-14T09:30:00+02:00;8;Vorarlberg;7044180;1517719;5526461
2022-05-14T09:30:00+02:00;9;Wien;63100725;55534486;7566239
2022-05-14T09:30:00+02:00;10;Österreich;184964595;92149436;92815159
2022-05-15T09:30:00+02:00;1;Burgenland;5188111;1659787;3528324
2022-05-15T09:30:00+02:00;2;Kärnten;6569518;1496099;5073419
2022-05-15T09:30:00+02:00;3;Niederösterreich;37960787;13337155;24623632
2022-05-15T09:30:00+02:00;4;Oberösterreich;24203419;6180155;18023264
2022-05-15T09:30:00+02:00;5;Salzburg;10559380;3015761;7543619
2022-05-15T09:30:00+02:00;6;Steiermark;20846317;5658843;15187474
2022-05-15T09:30:00+02:00;7;Tirol;9512700;3767866;5744834
2022-05-15T09:30:00+02:00;8;Vorarlberg;7044909;1518230;5526679
2022-05-15T09:30:00+02:00;9;Wien;63149764;55582349;7567415
2022-05-15T09:30:00+02:00;10;Österreich;185034905;92216245;92818660
2022-05-16T09:30:00+02:00;1;Burgenland;5190121;1661653;3528468
2022-05-16T09:30:00+02:00;2;Kärnten;6570442;1496924;5073518
2022-05-16T09:30:00+02:00;3;Niederösterreich;38344154;13504462;24839692
2022-05-16T09:30:00+02:00;4;Oberösterreich;24206532;6182271;18024261
2022-05-16T09:30:00+02:00;5;Salzburg;10560475;3016592;7543883
2022-05-16T09:30:00+02:00;6;Steiermark;20849544;5661580;15187964
2022-05-16T09:30:00+02:00;7;Tirol;9513819;3768985;5744834
2022-05-16T09:30:00+02:00;8;Vorarlberg;7045600;1518694;5526906
2022-05-16T09:30:00+02:00;9;Wien;63189351;55620623;7568728
2022-05-16T09:30:00+02:00;10;Österreich;185470038;92431784;93038254
2022-05-17T09:30:00+02:00;1;Burgenland;5192374;1663442;3528932
2022-05-17T09:30:00+02:00;2;Kärnten;6574650;1498404;5076246
2022-05-17T09:30:00+02:00;3;Niederösterreich;38354002;13511652;24842350
2022-05-17T09:30:00+02:00;4;Oberösterreich;24215561;6185368;18030193
2022-05-17T09:30:00+02:00;5;Salzburg;10562432;3018145;7544287
2022-05-17T09:30:00+02:00;6;Steiermark;20854185;5664874;15189311
2022-05-17T09:30:00+02:00;7;Tirol;9516789;3771955;5744834
2022-05-17T09:30:00+02:00;8;Vorarlberg;7047140;1519442;5527698
2022-05-17T09:30:00+02:00;9;Wien;63308794;55738652;7570142
2022-05-17T09:30:00+02:00;10;Österreich;185625927;92571934;93053993
2022-05-18T09:30:00+02:00;1;Burgenland;5196120;1666741;3529379
2022-05-18T09:30:00+02:00;2;Kärnten;6575600;1499335;5076265
2022-05-18T09:30:00+02:00;3;Niederösterreich;38403541;13554303;24849238
2022-05-18T09:30:00+02:00;4;Oberösterreich;24220567;6187418;18033149
2022-05-18T09:30:00+02:00;5;Salzburg;10564088;3019471;7544617
2022-05-18T09:30:00+02:00;6;Steiermark;20875099;5670995;15204104
2022-05-18T09:30:00+02:00;7;Tirol;9519224;3774390;5744834
2022-05-18T09:30:00+02:00;8;Vorarlberg;7048288;1520065;5528223
2022-05-18T09:30:00+02:00;9;Wien;63448736;55878113;7570623
2022-05-18T09:30:00+02:00;10;Österreich;185851263;92770831;93080432
2022-05-19T09:30:00+02:00;1;Burgenland;5199972;1670070;3529902
2022-05-19T09:30:00+02:00;2;Kärnten;6579770;1500364;5079406
2022-05-19T09:30:00+02:00;3;Niederösterreich;38411450;13560412;24851038
2022-05-19T09:30:00+02:00;4;Oberösterreich;24236916;6189925;18046991
2022-05-19T09:30:00+02:00;5;Salzburg;10565636;3020735;7544901
2022-05-19T09:30:00+02:00;6;Steiermark;20880712;5675494;15205218
2022-05-19T09:30:00+02:00;7;Tirol;9521250;3776416;5744834
2022-05-19T09:30:00+02:00;8;Vorarlberg;7049392;1520646;5528746
2022-05-19T09:30:00+02:00;9;Wien;63542023;55970217;7571806
2022-05-19T09:30:00+02:00;10;Österreich;185987121;92884279;93102842
2022-05-20T09:30:00+02:00;1;Burgenland;5202841;1672440;3530401
2022-05-20T09:30:00+02:00;2;Kärnten;6580637;1500980;5079657
2022-05-20T09:30:00+02:00;3;Niederösterreich;38547864;13694979;24852885
2022-05-20T09:30:00+02:00;4;Oberösterreich;24241658;6193265;18048393
2022-05-20T09:30:00+02:00;5;Salzburg;10566774;3021540;7545234
2022-05-20T09:30:00+02:00;6;Steiermark;20885992;5680191;15205801
2022-05-20T09:30:00+02:00;7;Tirol;9523073;3778239;5744834
2022-05-20T09:30:00+02:00;8;Vorarlberg;7050289;1521016;5529273
2022-05-20T09:30:00+02:00;9;Wien;63615765;56042818;7572947
2022-05-20T09:30:00+02:00;10;Österreich;186214893;93105468;93109425
2022-05-21T09:30:00+02:00;1;Burgenland;5208379;1674558;3533821
2022-05-21T09:30:00+02:00;2;Kärnten;6581244;1501550;5079694
2022-05-21T09:30:00+02:00;3;Niederösterreich;38585230;13701055;24884175
2022-05-21T09:30:00+02:00;4;Oberösterreich;24245099;6195466;18049633
2022-05-21T09:30:00+02:00;5;Salzburg;10568489;3022969;7545520
2022-05-21T09:30:00+02:00;6;Steiermark;20890257;5683914;15206343
2022-05-21T09:30:00+02:00;7;Tirol;9524823;3779989;5744834
2022-05-21T09:30:00+02:00;8;Vorarlberg;7051256;1521588;5529668
2022-05-21T09:30:00+02:00;9;Wien;63672751;56098679;7574072
2022-05-21T09:30:00+02:00;10;Österreich;186327528;93179768;93147760
2022-05-22T09:30:00+02:00;1;Burgenland;5210835;1676873;3533962
2022-05-22T09:30:00+02:00;2;Kärnten;6581746;1502041;5079705
2022-05-22T09:30:00+02:00;3;Niederösterreich;38590429;13705899;24884530
2022-05-22T09:30:00+02:00;4;Oberösterreich;24246421;6195995;18050426
2022-05-22T09:30:00+02:00;5;Salzburg;10569411;3023642;7545769
2022-05-22T09:30:00+02:00;6;Steiermark;20893735;5687216;15206519
2022-05-22T09:30:00+02:00;7;Tirol;9526239;3781405;5744834
2022-05-22T09:30:00+02:00;8;Vorarlberg;7051703;1521789;5529914
2022-05-22T09:30:00+02:00;9;Wien;63710826;56135582;7575244
2022-05-22T09:30:00+02:00;10;Österreich;186381345;93230442;93150903
2022-05-23T09:30:00+02:00;1;Burgenland;5212582;1678476;3534106
2022-05-23T09:30:00+02:00;2;Kärnten;6582324;1502468;5079856
2022-05-23T09:30:00+02:00;3;Niederösterreich;38594115;13709334;24884781
2022-05-23T09:30:00+02:00;4;Oberösterreich;24250938;6199529;18051409
2022-05-23T09:30:00+02:00;5;Salzburg;10570466;3024508;7545958
2022-05-23T09:30:00+02:00;6;Steiermark;20896202;5689638;15206564
2022-05-23T09:30:00+02:00;7;Tirol;9527066;3782232;5744834
2022-05-23T09:30:00+02:00;8;Vorarlberg;7052326;1522147;5530179
2022-05-23T09:30:00+02:00;9;Wien;63735052;56158454;7576598
2022-05-23T09:30:00+02:00;10;Österreich;186421071;93266786;93154285
2022-05-24T09:30:00+02:00;1;Burgenland;5214864;1680018;3534846
2022-05-24T09:30:00+02:00;2;Kärnten;6585890;1504047;5081843
2022-05-24T09:30:00+02:00;3;Niederösterreich;38735221;13715392;25019829
2022-05-24T09:30:00+02:00;4;Oberösterreich;24253754;6201938;18051816
2022-05-24T09:30:00+02:00;5;Salzburg;10572258;3025926;7546332
2022-05-24T09:30:00+02:00;6;Steiermark;20900880;5693385;15207495
2022-05-24T09:30:00+02:00;7;Tirol;9529433;3784599;5744834
2022-05-24T09:30:00+02:00;8;Vorarlberg;7053622;1522752;5530870
2022-05-24T09:30:00+02:00;9;Wien;63865492;56287659;7577833
2022-05-24T09:30:00+02:00;10;Österreich;186711414;93415716;93295698
2022-05-25T09:30:00+02:00;1;Burgenland;5302462;1767136;3535326
2022-05-25T09:30:00+02:00;2;Kärnten;6585890;1504047;5081843
2022-05-25T09:30:00+02:00;3;Niederösterreich;38746059;13721116;25024943
2022-05-25T09:30:00+02:00;4;Oberösterreich;24260169;6203690;18056479
2022-05-25T09:30:00+02:00;5;Salzburg;10573798;3027179;7546619
2022-05-25T09:30:00+02:00;6;Steiermark;20919353;5698894;15220459
2022-05-25T09:30:00+02:00;7;Tirol;9531349;3786515;5744834
2022-05-25T09:30:00+02:00;8;Vorarlberg;7054630;1523248;5531382
2022-05-25T09:30:00+02:00;9;Wien;63994602;56415581;7579021
2022-05-25T09:30:00+02:00;10;Österreich;186968312;93647406;93320906
2022-05-26T09:30:00+02:00;1;Burgenland;5305790;1770078;3535712
2022-05-26T09:30:00+02:00;2;Kärnten;6585890;1504047;5081843
2022-05-26T09:30:00+02:00;3;Niederösterreich;38912628;13862485;25050143
2022-05-26T09:30:00+02:00;4;Oberösterreich;24263486;6205506;18057980
2022-05-26T09:30:00+02:00;5;Salzburg;10575358;3028358;7547000
2022-05-26T09:30:00+02:00;6;Steiermark;20923470;5702351;15221119
2022-05-26T09:30:00+02:00;7;Tirol;9533172;3788338;5744834
2022-05-26T09:30:00+02:00;8;Vorarlberg;7055636;1523737;5531899
2022-05-26T09:30:00+02:00;9;Wien;64072055;56491226;7580829
2022-05-26T09:30:00+02:00;10;Österreich;187227485;93876126;93351359
2022-05-27T09:30:00+02:00;1;Burgenland;5309197;1773321;3535876
2022-05-27T09:30:00+02:00;2;Kärnten;6585890;1504047;5081843
2022-05-27T09:30:00+02:00;3;Niederösterreich;38918386;13867336;25051050
2022-05-27T09:30:00+02:00;4;Oberösterreich;24266552;6207726;18058826
2022-05-27T09:30:00+02:00;5;Salzburg;10576242;3028994;7547248
2022-05-27T09:30:00+02:00;6;Steiermark;20927593;5705647;15221946
2022-05-27T09:30:00+02:00;7;Tirol;9533725;3788891;5744834
2022-05-27T09:30:00+02:00;8;Vorarlberg;7056154;1524024;5532130
2022-05-27T09:30:00+02:00;9;Wien;64111304;56528592;7582712
2022-05-27T09:30:00+02:00;10;Österreich;187285043;93928578;93356465
2022-05-28T09:30:00+02:00;1;Burgenland;5310859;1773847;3537012
2022-05-28T09:30:00+02:00;2;Kärnten;6585890;1504047;5081843
2022-05-28T09:30:00+02:00;3;Niederösterreich;38923291;13871299;25051992
2022-05-28T09:30:00+02:00;4;Oberösterreich;24269643;6209817;18059826
2022-05-28T09:30:00+02:00;5;Salzburg;10577284;3029807;7547477
2022-05-28T09:30:00+02:00;6;Steiermark;20929794;5707084;15222710
2022-05-28T09:30:00+02:00;7;Tirol;9535056;3790222;5744834
2022-05-28T09:30:00+02:00;8;Vorarlberg;7056864;1524419;5532445
2022-05-28T09:30:00+02:00;9;Wien;64143572;56559082;7584490
2022-05-28T09:30:00+02:00;10;Österreich;187332253;93969624;93362629
2022-05-29T09:30:00+02:00;1;Burgenland;5313708;1776657;3537051
2022-05-29T09:30:00+02:00;2;Kärnten;6585890;1504047;5081843
2022-05-29T09:30:00+02:00;3;Niederösterreich;38928322;13876168;25052154
2022-05-29T09:30:00+02:00;4;Oberösterreich;24271774;6211356;18060418
2022-05-29T09:30:00+02:00;5;Salzburg;10578287;3030631;7547656
2022-05-29T09:30:00+02:00;6;Steiermark;20932696;5709781;15222915
2022-05-29T09:30:00+02:00;7;Tirol;9536264;3791430;5744834
2022-05-29T09:30:00+02:00;8;Vorarlberg;7057234;1524602;5532632
2022-05-29T09:30:00+02:00;9;Wien;64187822;56601520;7586302
2022-05-29T09:30:00+02:00;10;Österreich;187391997;94026192;93365805
2022-05-30T09:30:00+02:00;1;Burgenland;5315357;1778177;3537180
2022-05-30T09:30:00+02:00;2;Kärnten;6585890;1504047;5081843
2022-05-30T09:30:00+02:00;3;Niederösterreich;38932755;13879679;25053076
2022-05-30T09:30:00+02:00;4;Oberösterreich;24273415;6212721;18060694
2022-05-30T09:30:00+02:00;5;Salzburg;10579028;3031190;7547838
2022-05-30T09:30:00+02:00;6;Steiermark;20935246;5711757;15223489
2022-05-30T09:30:00+02:00;7;Tirol;9537000;3792166;5744834
2022-05-30T09:30:00+02:00;8;Vorarlberg;7057754;1524894;5532860
2022-05-30T09:30:00+02:00;9;Wien;64220837;56632516;7588321
2022-05-30T09:30:00+02:00;10;Österreich;187437282;94067147;93370135
2022-05-31T09:30:00+02:00;1;Burgenland;5317090;1779453;3537637
2022-05-31T09:30:00+02:00;2;Kärnten;6591553;1507950;5083603
2022-05-31T09:30:00+02:00;3;Niederösterreich;38936306;13882424;25053882
2022-05-31T09:30:00+02:00;4;Oberösterreich;24278968;6214710;18064258
2022-05-31T09:30:00+02:00;5;Salzburg;10580601;3032431;7548170
2022-05-31T09:30:00+02:00;6;Steiermark;20940744;5715755;15224989
2022-05-31T09:30:00+02:00;7;Tirol;9538747;3793913;5744834
2022-05-31T09:30:00+02:00;8;Vorarlberg;7058910;1525316;5533594
2022-05-31T09:30:00+02:00;9;Wien;64254942;56664637;7590305
2022-05-31T09:30:00+02:00;10;Österreich;187497861;94116589;93381272
2022-06-01T09:30:00+02:00;1;Burgenland;5321206;1783113;3538093
2022-06-01T09:30:00+02:00;2;Kärnten;6593081;1508934;5084147
2022-06-01T09:30:00+02:00;3;Niederösterreich;38945221;13887286;25057935
2022-06-01T09:30:00+02:00;4;Oberösterreich;24288800;6216917;18071883
2022-06-01T09:30:00+02:00;5;Salzburg;10582478;3034041;7548437
2022-06-01T09:30:00+02:00;6;Steiermark;20955641;5721117;15234524
2022-06-01T09:30:00+02:00;7;Tirol;9541011;3796177;5744834
2022-06-01T09:30:00+02:00;8;Vorarlberg;7059869;1525849;5534020
2022-06-01T09:30:00+02:00;9;Wien;64459599;56867408;7592191
2022-06-01T09:30:00+02:00;10;Österreich;187746906;94340842;93406064
2022-06-02T09:30:00+02:00;1;Burgenland;5324370;1786076;3538294
2022-06-02T09:30:00+02:00;2;Kärnten;6594793;1510436;5084357
2022-06-02T09:30:00+02:00;3;Niederösterreich;38979722;13919786;25059936
2022-06-02T09:30:00+02:00;4;Oberösterreich;24309450;6218639;18090811
2022-06-02T09:30:00+02:00;5;Salzburg;10583932;3035092;7548840
2022-06-02T09:30:00+02:00;6;Steiermark;20960671;5725159;15235512
2022-06-02T09:30:00+02:00;7;Tirol;9542568;3797734;5744834
2022-06-02T09:30:00+02:00;8;Vorarlberg;7060765;1526313;5534452
2022-06-02T09:30:00+02:00;9;Wien;64544298;56951132;7593166
2022-06-02T09:30:00+02:00;10;Österreich;187900569;94470367;93430202
2022-06-03T09:30:00+02:00;1;Burgenland;5242424;1703779;3538645
2022-06-03T09:30:00+02:00;2;Kärnten;6597659;1510973;5086686
2022-06-03T09:30:00+02:00;3;Niederösterreich;39136445;14059635;25076810
2022-06-03T09:30:00+02:00;4;Oberösterreich;24313469;6221244;18092225
2022-06-03T09:30:00+02:00;5;Salzburg;10585317;3036202;7549115
2022-06-03T09:30:00+02:00;6;Steiermark;20965433;5729286;15236147
2022-06-03T09:30:00+02:00;7;Tirol;9543759;3798925;5744834
2022-06-03T09:30:00+02:00;8;Vorarlberg;7061685;1526743;5534942
2022-06-03T09:30:00+02:00;9;Wien;64598585;57004439;7594146
2022-06-03T09:30:00+02:00;10;Österreich;188044776;94591226;93453550
2022-06-04T09:30:00+02:00;1;Burgenland;5245004;1705915;3539089
2022-06-04T09:30:00+02:00;2;Kärnten;6598132;1511391;5086741
2022-06-04T09:30:00+02:00;3;Niederösterreich;39142359;14064407;25077952
2022-06-04T09:30:00+02:00;4;Oberösterreich;24317223;6224012;18093211
2022-06-04T09:30:00+02:00;5;Salzburg;10586263;3036906;7549357
2022-06-04T09:30:00+02:00;6;Steiermark;20969551;5732306;15237245
2022-06-04T09:30:00+02:00;7;Tirol;9545012;3800178;5744834
2022-06-04T09:30:00+02:00;8;Vorarlberg;7062427;1527171;5535256
2022-06-04T09:30:00+02:00;9;Wien;64641230;57046041;7595189
2022-06-04T09:30:00+02:00;10;Österreich;188107201;94648327;93458874
2022-06-05T09:30:00+02:00;1;Burgenland;5247275;1707957;3539318
2022-06-05T09:30:00+02:00;2;Kärnten;6598550;1511800;5086750
2022-06-05T09:30:00+02:00;3;Niederösterreich;39146447;14068315;25078132
2022-06-05T09:30:00+02:00;4;Oberösterreich;24319358;6225556;18093802
2022-06-05T09:30:00+02:00;5;Salzburg;10587230;3037773;7549457
2022-06-05T09:30:00+02:00;6;Steiermark;20972341;5734774;15237567
2022-06-05T09:30:00+02:00;7;Tirol;9546079;3801245;5744834
2022-06-05T09:30:00+02:00;8;Vorarlberg;7062810;1527393;5535417
2022-06-05T09:30:00+02:00;9;Wien;64668815;57072661;7596154
2022-06-05T09:30:00+02:00;10;Österreich;188148905;94687474;93461431
2022-06-06T09:30:00+02:00;1;Burgenland;5248794;1709442;3539352
2022-06-06T09:30:00+02:00;2;Kärnten;6598665;1511914;5086751
2022-06-06T09:30:00+02:00;3;Niederösterreich;39149837;14071646;25078191
2022-06-06T09:30:00+02:00;4;Oberösterreich;24320929;6226556;18094373
2022-06-06T09:30:00+02:00;5;Salzburg;10587858;3038292;7549566
2022-06-06T09:30:00+02:00;6;Steiermark;20973892;5736165;15237727
2022-06-06T09:30:00+02:00;7;Tirol;9546772;3801938;5744834
2022-06-06T09:30:00+02:00;8;Vorarlberg;7063367;1527787;5535580
2022-06-06T09:30:00+02:00;9;Wien;64679613;57082401;7597212
2022-06-06T09:30:00+02:00;10;Österreich;188169727;94706141;93463586
2022-06-07T09:30:00+02:00;1;Burgenland;5250117;1710669;3539448
2022-06-07T09:30:00+02:00;2;Kärnten;6599419;1512588;5086831
2022-06-07T09:30:00+02:00;3;Niederösterreich;39152585;14074165;25078420
2022-06-07T09:30:00+02:00;4;Oberösterreich;24324780;6228352;18096428
2022-06-07T09:30:00+02:00;5;Salzburg;10588702;3038964;7549738
2022-06-07T09:30:00+02:00;6;Steiermark;20974847;5736720;15238127
2022-06-07T09:30:00+02:00;7;Tirol;9547746;3802912;5744834
2022-06-07T09:30:00+02:00;8;Vorarlberg;7063930;1528083;5535847
2022-06-07T09:30:00+02:00;9;Wien;64710107;57111872;7598235
2022-06-07T09:30:00+02:00;10;Österreich;188212233;94744325;93467908
2022-06-08T09:30:00+02:00;1;Burgenland;5251725;1711915;3539810
2022-06-08T09:30:00+02:00;2;Kärnten;6602190;1513741;5088449
2022-06-08T09:30:00+02:00;3;Niederösterreich;39160230;14078527;25081703
2022-06-08T09:30:00+02:00;4;Oberösterreich;24355347;6230321;18125026
2022-06-08T09:30:00+02:00;5;Salzburg;10590483;3040526;7549957
2022-06-08T09:30:00+02:00;6;Steiermark;20987249;5739537;15247712
2022-06-08T09:30:00+02:00;7;Tirol;9549920;3805086;5744834
2022-06-08T09:30:00+02:00;8;Vorarlberg;7065362;1528872;5536490
2022-06-08T09:30:00+02:00;9;Wien;64752690;57153418;7599272
2022-06-08T09:30:00+02:00;10;Österreich;188315196;94801943;93513253
2022-06-09T09:30:00+02:00;1;Burgenland;5256002;1715565;3540437
2022-06-09T09:30:00+02:00;2;Kärnten;6603326;1514725;5088601
2022-06-09T09:30:00+02:00;3;Niederösterreich;39285543;14082298;25203245
2022-06-09T09:30:00+02:00;4;Oberösterreich;24367054;6231765;18135289
2022-06-09T09:30:00+02:00;5;Salzburg;10592076;3041828;7550248
2022-06-09T09:30:00+02:00;6;Steiermark;20995202;5744927;15250275
2022-06-09T09:30:00+02:00;7;Tirol;9551738;3806904;5744834
2022-06-09T09:30:00+02:00;8;Vorarlberg;7066382;1529393;5536989
2022-06-09T09:30:00+02:00;9;Wien;64834843;57234172;7600671
2022-06-09T09:30:00+02:00;10;Österreich;188552166;94901577;93650589
2022-06-10T09:30:00+02:00;1;Burgenland;5263305;1718030;3545275
2022-06-10T09:30:00+02:00;2;Kärnten;6603908;1515304;5088604
2022-06-10T09:30:00+02:00;3;Niederösterreich;39290186;14085991;25204195
2022-06-10T09:30:00+02:00;4;Oberösterreich;24370320;6233486;18136834
2022-06-10T09:30:00+02:00;5;Salzburg;10593536;3043013;7550523
2022-06-10T09:30:00+02:00;6;Steiermark;21005744;5748743;15257001
2022-06-10T09:30:00+02:00;7;Tirol;9553323;3808489;5744834
2022-06-10T09:30:00+02:00;8;Vorarlberg;7067439;1529994;5537445
2022-06-10T09:30:00+02:00;9;Wien;64888225;57286176;7602049
2022-06-10T09:30:00+02:00;10;Österreich;188635986;94969226;93666760
2022-06-11T09:30:00+02:00;1;Burgenland;5265883;1720158;3545725
2022-06-11T09:30:00+02:00;2;Kärnten;6604838;1515706;5089132
2022-06-11T09:30:00+02:00;3;Niederösterreich;39295042;14089925;25205117
2022-06-11T09:30:00+02:00;4;Oberösterreich;24374239;6236112;18138127
2022-06-11T09:30:00+02:00;5;Salzburg;10594779;3044043;7550736
2022-06-11T09:30:00+02:00;6;Steiermark;21009518;5751662;15257856
2022-06-11T09:30:00+02:00;7;Tirol;9554996;3810162;5744834
2022-06-11T09:30:00+02:00;8;Vorarlberg;7068530;1530615;5537915
2022-06-11T09:30:00+02:00;9;Wien;64925129;57321731;7603398
2022-06-11T09:30:00+02:00;10;Österreich;188692954;95020114;93672840
2022-06-12T09:30:00+02:00;1;Burgenland;5268347;1722428;3545919
2022-06-12T09:30:00+02:00;2;Kärnten;6605217;1516083;5089134
2022-06-12T09:30:00+02:00;3;Niederösterreich;39300249;14094320;25205929
2022-06-12T09:30:00+02:00;4;Oberösterreich;24376737;6237959;18138778
2022-06-12T09:30:00+02:00;5;Salzburg;10595713;3044827;7550886
2022-06-12T09:30:00+02:00;6;Steiermark;21012921;5754708;15258213
2022-06-12T09:30:00+02:00;7;Tirol;9556291;3811457;5744834
2022-06-12T09:30:00+02:00;8;Vorarlberg;7068968;1530884;5538084
2022-06-12T09:30:00+02:00;9;Wien;64940717;57336162;7604555
2022-06-12T09:30:00+02:00;10;Österreich;188725160;95048828;93676332
2022-06-13T09:30:00+02:00;1;Burgenland;5270135;1724120;3546015
2022-06-13T09:30:00+02:00;2;Kärnten;6605995;1516748;5089247
2022-06-13T09:30:00+02:00;3;Niederösterreich;39302952;14096850;25206102
2022-06-13T09:30:00+02:00;4;Oberösterreich;24379381;6239646;18139735
2022-06-13T09:30:00+02:00;5;Salzburg;10596640;3045604;7551036
2022-06-13T09:30:00+02:00;6;Steiermark;21014780;5756267;15258513
2022-06-13T09:30:00+02:00;7;Tirol;9557187;3812353;5744834
2022-06-13T09:30:00+02:00;8;Vorarlberg;7069647;1531399;5538248
2022-06-13T09:30:00+02:00;9;Wien;64995895;57389991;7605904
2022-06-13T09:30:00+02:00;10;Österreich;188792612;95112978;93679634
2022-06-14T09:30:00+02:00;1;Burgenland;5274729;1725608;3549121
2022-06-14T09:30:00+02:00;2;Kärnten;6608915;1517924;5090991
2022-06-14T09:30:00+02:00;3;Niederösterreich;39324573;14100754;25223819
2022-06-14T09:30:00+02:00;4;Oberösterreich;24383866;6242011;18141855
2022-06-14T09:30:00+02:00;5;Salzburg;10604554;3047058;7557496
2022-06-14T09:30:00+02:00;6;Steiermark;21018855;5759079;15259776
2022-06-14T09:30:00+02:00;7;Tirol;9559661;3814827;5744834
2022-06-14T09:30:00+02:00;8;Vorarlberg;7071270;1532324;5538946
2022-06-14T09:30:00+02:00;9;Wien;65057831;57450325;7607506
2022-06-14T09:30:00+02:00;10;Österreich;188904254;95189910;93714344
2022-06-15T09:30:00+02:00;1;Burgenland;5278302;1728940;3549362
2022-06-15T09:30:00+02:00;2;Kärnten;6610302;1518842;5091460
2022-06-15T09:30:00+02:00;3;Niederösterreich;39420898;14130738;25290160
2022-06-15T09:30:00+02:00;4;Oberösterreich;24392425;6243918;18148507
2022-06-15T09:30:00+02:00;5;Salzburg;10606122;3048366;7557756
2022-06-15T09:30:00+02:00;6;Steiermark;21035534;5763912;15271622
2022-06-15T09:30:00+02:00;7;Tirol;9561642;3816808;5744834
2022-06-15T09:30:00+02:00;8;Vorarlberg;7072473;1533016;5539457
2022-06-15T09:30:00+02:00;9;Wien;65121369;57512522;7608847
2022-06-15T09:30:00+02:00;10;Österreich;189099067;95297062;93802005
2022-06-16T09:30:00+02:00;1;Burgenland;5280940;1731452;3549488
2022-06-16T09:30:00+02:00;2;Kärnten;6611636;1519421;5092215
2022-06-16T09:30:00+02:00;3;Niederösterreich;39425468;14134571;25290897
2022-06-16T09:30:00+02:00;4;Oberösterreich;24407755;6246078;18161677
2022-06-16T09:30:00+02:00;5;Salzburg;10607705;3049685;7558020
2022-06-16T09:30:00+02:00;6;Steiermark;21040155;5767639;15272516
2022-06-16T09:30:00+02:00;7;Tirol;9563985;3819151;5744834
2022-06-16T09:30:00+02:00;8;Vorarlberg;7073819;1533862;5539957
2022-06-16T09:30:00+02:00;9;Wien;65176802;57567601;7609201
2022-06-16T09:30:00+02:00;10;Österreich;189188265;95369460;93818805
2022-06-17T09:30:00+02:00;1;Burgenland;5283636;1734008;3549628
2022-06-17T09:30:00+02:00;2;Kärnten;6612244;1520029;5092215
2022-06-17T09:30:00+02:00;3;Niederösterreich;39442216;14137845;25304371
2022-06-17T09:30:00+02:00;4;Oberösterreich;24409800;6248078;18161722
2022-06-17T09:30:00+02:00;5;Salzburg;10608829;3050652;7558177
2022-06-17T09:30:00+02:00;6;Steiermark;21043361;5770597;15272764
2022-06-17T09:30:00+02:00;7;Tirol;9564862;3820028;5744834
2022-06-17T09:30:00+02:00;8;Vorarlberg;7074366;1534181;5540185
2022-06-17T09:30:00+02:00;9;Wien;65210060;57600527;7609533
2022-06-17T09:30:00+02:00;10;Österreich;189249374;95415945;93833429
2022-06-18T09:30:00+02:00;1;Burgenland;5285742;1735412;3550330
2022-06-18T09:30:00+02:00;2;Kärnten;6612762;1520547;5092215
2022-06-18T09:30:00+02:00;3;Niederösterreich;39446879;14141821;25305058
2022-06-18T09:30:00+02:00;4;Oberösterreich;24414251;6250574;18163677
2022-06-18T09:30:00+02:00;5;Salzburg;10610246;3051878;7558368
2022-06-18T09:30:00+02:00;6;Steiermark;21045711;5772281;15273430
2022-06-18T09:30:00+02:00;7;Tirol;9567042;3822208;5744834
2022-06-18T09:30:00+02:00;8;Vorarlberg;7075576;1535006;5540570
2022-06-18T09:30:00+02:00;9;Wien;65249884;57639925;7609959
2022-06-18T09:30:00+02:00;10;Österreich;189308093;95469652;93838441
2022-06-19T09:30:00+02:00;1;Burgenland;5288629;1738192;3550437
2022-06-19T09:30:00+02:00;2;Kärnten;6613243;1521028;5092215
2022-06-19T09:30:00+02:00;3;Niederösterreich;39450313;14145118;25305195
2022-06-19T09:30:00+02:00;4;Oberösterreich;24416271;6251986;18164285
2022-06-19T09:30:00+02:00;5;Salzburg;10611448;3052956;7558492
2022-06-19T09:30:00+02:00;6;Steiermark;21050141;5776398;15273743
2022-06-19T09:30:00+02:00;7;Tirol;9568880;3824046;5744834
2022-06-19T09:30:00+02:00;8;Vorarlberg;7076300;1535533;5540767
2022-06-19T09:30:00+02:00;9;Wien;65284005;57673681;7610324
2022-06-19T09:30:00+02:00;10;Österreich;189359230;95518938;93840292
2022-06-20T09:30:00+02:00;1;Burgenland;5290643;1740168;3550475
2022-06-20T09:30:00+02:00;2;Kärnten;6614122;1521822;5092300
2022-06-20T09:30:00+02:00;3;Niederösterreich;39453683;14148333;25305350
2022-06-20T09:30:00+02:00;4;Oberösterreich;24418635;6253394;18165241
2022-06-20T09:30:00+02:00;5;Salzburg;10612649;3054029;7558620
2022-06-20T09:30:00+02:00;6;Steiermark;21052993;5778931;15274062
2022-06-20T09:30:00+02:00;7;Tirol;9570280;3825446;5744834
2022-06-20T09:30:00+02:00;8;Vorarlberg;7077123;1536144;5540979
2022-06-20T09:30:00+02:00;9;Wien;65322954;57712163;7610791
2022-06-20T09:30:00+02:00;10;Österreich;189413082;95570430;93842652
2022-06-21T09:30:00+02:00;1;Burgenland;5293290;1742258;3551032
2022-06-21T09:30:00+02:00;2;Kärnten;6615722;1523055;5092667
2022-06-21T09:30:00+02:00;3;Niederösterreich;39459006;14152291;25306715
2022-06-21T09:30:00+02:00;4;Oberösterreich;24499942;6256073;18243869
2022-06-21T09:30:00+02:00;5;Salzburg;10622000;3056141;7565859
2022-06-21T09:30:00+02:00;6;Steiermark;21057021;5781629;15275392
2022-06-21T09:30:00+02:00;7;Tirol;9573558;3828724;5744834
2022-06-21T09:30:00+02:00;8;Vorarlberg;7079193;1537508;5541685
2022-06-21T09:30:00+02:00;9;Wien;65388337;57777053;7611284
2022-06-21T09:30:00+02:00;10;Österreich;189588069;95654732;93933337
2022-06-22T09:30:00+02:00;1;Burgenland;5296934;1745725;3551209
2022-06-22T09:30:00+02:00;2;Kärnten;6617326;1524024;5093302
2022-06-22T09:30:00+02:00;3;Niederösterreich;39467754;14157805;25309949
2022-06-22T09:30:00+02:00;4;Oberösterreich;24504374;6258539;18245835
2022-06-22T09:30:00+02:00;5;Salzburg;10623733;3057581;7566152
2022-06-22T09:30:00+02:00;6;Steiermark;21065954;5789572;15276382
2022-06-22T09:30:00+02:00;7;Tirol;9576139;3831305;5744834
2022-06-22T09:30:00+02:00;8;Vorarlberg;7080581;1538448;5542133
2022-06-22T09:30:00+02:00;9;Wien;65461265;57849502;7611763
2022-06-22T09:30:00+02:00;10;Österreich;189694060;95752501;93941559
2022-06-23T09:30:00+02:00;1;Burgenland;5300705;1748542;3552163
2022-06-23T09:30:00+02:00;2;Kärnten;6618612;1524860;5093752
2022-06-23T09:30:00+02:00;3;Niederösterreich;39472851;14161998;25310853
2022-06-23T09:30:00+02:00;4;Oberösterreich;24517486;6260945;18256541
2022-06-23T09:30:00+02:00;5;Salzburg;10625599;3059193;7566406
2022-06-23T09:30:00+02:00;6;Steiermark;21072143;5794743;15277400
2022-06-23T09:30:00+02:00;7;Tirol;9578866;3834032;5744834
2022-06-23T09:30:00+02:00;8;Vorarlberg;7082043;1539397;5542646
2022-06-23T09:30:00+02:00;9;Wien;65523414;57911175;7612239
2022-06-23T09:30:00+02:00;10;Österreich;189791719;95834885;93956834
2022-06-24T09:30:00+02:00;1;Burgenland;5303122;1750435;3552687
2022-06-24T09:30:00+02:00;2;Kärnten;6622879;1525891;5096988
2022-06-24T09:30:00+02:00;3;Niederösterreich;39488037;14165585;25322452
2022-06-24T09:30:00+02:00;4;Oberösterreich;24522465;6264271;18258194
2022-06-24T09:30:00+02:00;5;Salzburg;10627745;3061011;7566734
2022-06-24T09:30:00+02:00;6;Steiermark;21078943;5800507;15278436
2022-06-24T09:30:00+02:00;7;Tirol;9581314;3836480;5744834
2022-06-24T09:30:00+02:00;8;Vorarlberg;7083273;1540130;5543143
2022-06-24T09:30:00+02:00;9;Wien;65586573;57973951;7612622
2022-06-24T09:30:00+02:00;10;Österreich;189894351;95918261;93976090
2022-06-25T09:30:00+02:00;1;Burgenland;5306898;1753408;3553490
2022-06-25T09:30:00+02:00;2;Kärnten;6623538;1526543;5096995
2022-06-25T09:30:00+02:00;3;Niederösterreich;39495284;14171953;25323331
2022-06-25T09:30:00+02:00;4;Oberösterreich;24526831;6267374;18259457
2022-06-25T09:30:00+02:00;5;Salzburg;10629419;3062431;7566988
2022-06-25T09:30:00+02:00;6;Steiermark;21084645;5805271;15279374
2022-06-25T09:30:00+02:00;7;Tirol;9583637;3838803;5744834
2022-06-25T09:30:00+02:00;8;Vorarlberg;7084660;1541137;5543523
2022-06-25T09:30:00+02:00;9;Wien;65649802;58036721;7613081
2022-06-25T09:30:00+02:00;10;Österreich;189984714;96003641;93981073
2022-06-26T09:30:00+02:00;1;Burgenland;5309711;1756069;3553642
2022-06-26T09:30:00+02:00;2;Kärnten;6623864;1526864;5097000
2022-06-26T09:30:00+02:00;3;Niederösterreich;39500072;14176599;25323473
2022-06-26T09:30:00+02:00;4;Oberösterreich;24530160;6269926;18260234
2022-06-26T09:30:00+02:00;5;Salzburg;10630853;3063716;7567137
2022-06-26T09:30:00+02:00;6;Steiermark;21089190;5809436;15279754
2022-06-26T09:30:00+02:00;7;Tirol;9585834;3841000;5744834
2022-06-26T09:30:00+02:00;8;Vorarlberg;7085178;1541491;5543687
2022-06-26T09:30:00+02:00;9;Wien;65693636;58080121;7613515
2022-06-26T09:30:00+02:00;10;Österreich;190048498;96065222;93983276
2022-06-27T09:30:00+02:00;1;Burgenland;5312072;1758381;3553691
2022-06-27T09:30:00+02:00;2;Kärnten;6624795;1527769;5097026
2022-06-27T09:30:00+02:00;3;Niederösterreich;39504394;14180714;25323680
2022-06-27T09:30:00+02:00;4;Oberösterreich;24533137;6271857;18261280
2022-06-27T09:30:00+02:00;5;Salzburg;10632241;3064952;7567289
2022-06-27T09:30:00+02:00;6;Steiermark;21092838;5812726;15280112
2022-06-27T09:30:00+02:00;7;Tirol;9587477;3842643;5744834
2022-06-27T09:30:00+02:00;8;Vorarlberg;7086477;1542570;5543907
2022-06-27T09:30:00+02:00;9;Wien;65735292;58121290;7614002
2022-06-27T09:30:00+02:00;10;Österreich;190108723;96122902;93985821
2022-06-28T09:30:00+02:00;1;Burgenland;5317076;1761249;3555827
2022-06-28T09:30:00+02:00;2;Kärnten;6628795;1529420;5099375
2022-06-28T09:30:00+02:00;3;Niederösterreich;39513740;14186270;25327470
2022-06-28T09:30:00+02:00;4;Oberösterreich;24539832;6275343;18264489
2022-06-28T09:30:00+02:00;5;Salzburg;10640703;3067015;7573688
2022-06-28T09:30:00+02:00;6;Steiermark;21098196;5816694;15281502
2022-06-28T09:30:00+02:00;7;Tirol;9590745;3845911;5744834
2022-06-28T09:30:00+02:00;8;Vorarlberg;7088523;1543803;5544720
2022-06-28T09:30:00+02:00;9;Wien;65808360;58193874;7614486
2022-06-28T09:30:00+02:00;10;Österreich;190225970;96219579;94006391
2022-06-29T09:30:00+02:00;1;Burgenland;5321604;1765287;3556317
2022-06-29T09:30:00+02:00;2;Kärnten;6629884;1530509;5099375
2022-06-29T09:30:00+02:00;3;Niederösterreich;39558194;14228023;25330171
2022-06-29T09:30:00+02:00;4;Oberösterreich;24544528;6278183;18266345
2022-06-29T09:30:00+02:00;5;Salzburg;10642798;3068863;7573935
2022-06-29T09:30:00+02:00;6;Steiermark;21128634;5825678;15302956
2022-06-29T09:30:00+02:00;7;Tirol;9594203;3849369;5744834
2022-06-29T09:30:00+02:00;8;Vorarlberg;7090629;1545187;5545442
2022-06-29T09:30:00+02:00;9;Wien;65884970;58269979;7614991
2022-06-29T09:30:00+02:00;10;Österreich;190395444;96361078;94034366
2022-06-30T09:30:00+02:00;1;Burgenland;5325363;1768549;3556814
2022-06-30T09:30:00+02:00;2;Kärnten;6632493;1531465;5101028
2022-06-30T09:30:00+02:00;3;Niederösterreich;39564628;14232961;25331667
2022-06-30T09:30:00+02:00;4;Oberösterreich;24561362;6279983;18281379
2022-06-30T09:30:00+02:00;5;Salzburg;10644930;3070721;7574209
2022-06-30T09:30:00+02:00;6;Steiermark;21136292;5832128;15304164
2022-06-30T09:30:00+02:00;7;Tirol;9597438;3852604;5744834
2022-06-30T09:30:00+02:00;8;Vorarlberg;7092138;1546127;5546011
2022-06-30T09:30:00+02:00;9;Wien;65962358;58346914;7615444
2022-06-30T09:30:00+02:00;10;Österreich;190517002;96461452;94055550
2022-07-01T09:30:00+02:00;1;Burgenland;5328512;1771574;3556938
2022-07-01T09:30:00+02:00;2;Kärnten;6633304;1532273;5101031
2022-07-01T09:30:00+02:00;3;Niederösterreich;39570655;14237098;25333557
2022-07-01T09:30:00+02:00;4;Oberösterreich;24567208;6284191;18283017
2022-07-01T09:30:00+02:00;5;Salzburg;10647174;3072699;7574475
2022-07-01T09:30:00+02:00;6;Steiermark;21143591;5838385;15305206
2022-07-01T09:30:00+02:00;7;Tirol;9600356;3855522;5744834
2022-07-01T09:30:00+02:00;8;Vorarlberg;7093824;1547119;5546705
2022-07-01T09:30:00+02:00;9;Wien;66025576;58409690;7615886
2022-07-01T09:30:00+02:00;10;Österreich;190610200;96548551;94061649
2022-07-02T09:30:00+02:00;1;Burgenland;5333396;1774495;3558901
2022-07-02T09:30:00+02:00;2;Kärnten;6633948;1532914;5101034
2022-07-02T09:30:00+02:00;3;Niederösterreich;39578255;14243232;25335023
2022-07-02T09:30:00+02:00;4;Oberösterreich;24571705;6287265;18284440
2022-07-02T09:30:00+02:00;5;Salzburg;10649058;3074237;7574821
2022-07-02T09:30:00+02:00;6;Steiermark;21148521;5842371;15306150
2022-07-02T09:30:00+02:00;7;Tirol;9603286;3858452;5744834
2022-07-02T09:30:00+02:00;8;Vorarlberg;7095473;1548296;5547177
2022-07-02T09:30:00+02:00;9;Wien;66088229;58471927;7616302
2022-07-02T09:30:00+02:00;10;Österreich;190701871;96633189;94068682
2022-07-03T09:30:00+02:00;1;Burgenland;5336560;1777555;3559005
2022-07-03T09:30:00+02:00;2;Kärnten;6634700;1533665;5101035
2022-07-03T09:30:00+02:00;3;Niederösterreich;39584115;14248932;25335183
2022-07-03T09:30:00+02:00;4;Oberösterreich;24575520;6290340;18285180
2022-07-03T09:30:00+02:00;5;Salzburg;10650422;3075419;7575003
2022-07-03T09:30:00+02:00;6;Steiermark;21154416;5847874;15306542
2022-07-03T09:30:00+02:00;7;Tirol;9605891;3861057;5744834
2022-07-03T09:30:00+02:00;8;Vorarlberg;7096687;1549309;5547378
2022-07-03T09:30:00+02:00;9;Wien;66130812;58514146;7616666
2022-07-03T09:30:00+02:00;10;Österreich;190769123;96698297;94070826
2022-07-04T09:30:00+02:00;1;Burgenland;5339237;1780084;3559153
2022-07-04T09:30:00+02:00;2;Kärnten;6635942;1534238;5101704
2022-07-04T09:30:00+02:00;3;Niederösterreich;39589153;14253796;25335357
2022-07-04T09:30:00+02:00;4;Oberösterreich;24578812;6292594;18286218
2022-07-04T09:30:00+02:00;5;Salzburg;10652012;3076858;7575154
2022-07-04T09:30:00+02:00;6;Steiermark;21158180;5851249;15306931
2022-07-04T09:30:00+02:00;7;Tirol;9607640;3862806;5744834
2022-07-04T09:30:00+02:00;8;Vorarlberg;7097834;1550229;5547605
2022-07-04T09:30:00+02:00;9;Wien;66174532;58557360;7617172
2022-07-04T09:30:00+02:00;10;Österreich;190833342;96759214;94074128
2022-07-05T09:30:00+02:00;1;Burgenland;5341873;1782385;3559488
2022-07-05T09:30:00+02:00;2;Kärnten;6640313;1536685;5103628
2022-07-05T09:30:00+02:00;3;Niederösterreich;39612887;14260349;25352538
2022-07-05T09:30:00+02:00;4;Oberösterreich;24593789;6295923;18297866
2022-07-05T09:30:00+02:00;5;Salzburg;10661429;3078629;7582800
2022-07-05T09:30:00+02:00;6;Steiermark;21164595;5856138;15308457
2022-07-05T09:30:00+02:00;7;Tirol;9611842;3867008;5744834
2022-07-05T09:30:00+02:00;8;Vorarlberg;7099139;1550600;5548539
2022-07-05T09:30:00+02:00;9;Wien;66244356;58626697;7617659
2022-07-05T09:30:00+02:00;10;Österreich;190970223;96854414;94115809
2022-07-06T09:30:00+02:00;1;Burgenland;5346530;1786521;3560009
2022-07-06T09:30:00+02:00;2;Kärnten;6642464;1537761;5104703
2022-07-06T09:30:00+02:00;3;Niederösterreich;39621526;14266707;25354819
2022-07-06T09:30:00+02:00;4;Oberösterreich;24600352;6299046;18301306
2022-07-06T09:30:00+02:00;5;Salzburg;10663945;3080871;7583074
2022-07-06T09:30:00+02:00;6;Steiermark;21184532;5863600;15320932
2022-07-06T09:30:00+02:00;7;Tirol;9615321;3870487;5744834
2022-07-06T09:30:00+02:00;8;Vorarlberg;7101443;1552242;5549201
2022-07-06T09:30:00+02:00;9;Wien;66306135;58688046;7618089
2022-07-06T09:30:00+02:00;10;Österreich;191082248;96945281;94136967
2022-07-07T09:30:00+02:00;1;Burgenland;5349942;1789702;3560240
2022-07-07T09:30:00+02:00;2;Kärnten;6645081;1539278;5105803
2022-07-07T09:30:00+02:00;3;Niederösterreich;39633407;14273402;25360005
2022-07-07T09:30:00+02:00;4;Oberösterreich;24615100;6302015;18313085
2022-07-07T09:30:00+02:00;5;Salzburg;10666284;3082933;7583351
2022-07-07T09:30:00+02:00;6;Steiermark;21192733;5870703;15322030
2022-07-07T09:30:00+02:00;7;Tirol;9618852;3874018;5744834
2022-07-07T09:30:00+02:00;8;Vorarlberg;7103562;1553651;5549911
2022-07-07T09:30:00+02:00;9;Wien;66339481;58720929;7618552
2022-07-07T09:30:00+02:00;10;Österreich;191164442;97006631;94157811
2022-07-08T09:30:00+02:00;1;Burgenland;5352851;1792433;3560418
2022-07-08T09:30:00+02:00;2;Kärnten;6646445;1540642;5105803
2022-07-08T09:30:00+02:00;3;Niederösterreich;39639698;14278436;25361262
2022-07-08T09:30:00+02:00;4;Oberösterreich;24621022;6306086;18314936
2022-07-08T09:30:00+02:00;5;Salzburg;10668678;3084978;7583700
2022-07-08T09:30:00+02:00;6;Steiermark;21206691;5876842;15329849
2022-07-08T09:30:00+02:00;7;Tirol;9621798;3876964;5744834
2022-07-08T09:30:00+02:00;8;Vorarlberg;7105188;1554770;5550418
2022-07-08T09:30:00+02:00;9;Wien;66406390;58787343;7619047
2022-07-08T09:30:00+02:00;10;Österreich;191268761;97098494;94170267
2022-07-09T09:30:00+02:00;1;Burgenland;5359613;1796533;3563080
2022-07-09T09:30:00+02:00;2;Kärnten;6647323;1541520;5105803
2022-07-09T09:30:00+02:00;3;Niederösterreich;39647416;14284911;25362505
2022-07-09T09:30:00+02:00;4;Oberösterreich;24626213;6309886;18316327
2022-07-09T09:30:00+02:00;5;Salzburg;10670428;3086507;7583921
2022-07-09T09:30:00+02:00;6;Steiermark;21213395;5882623;15330772
2022-07-09T09:30:00+02:00;7;Tirol;9624848;3880014;5744834
2022-07-09T09:30:00+02:00;8;Vorarlberg;7107019;1556141;5550878
2022-07-09T09:30:00+02:00;9;Wien;66475836;58856356;7619480
2022-07-09T09:30:00+02:00;10;Österreich;191372091;97194491;94177600
2022-07-10T09:30:00+02:00;1;Burgenland;5362971;1799751;3563220
2022-07-10T09:30:00+02:00;2;Kärnten;6648076;1542270;5105806
2022-07-10T09:30:00+02:00;3;Niederösterreich;39652954;14290270;25362684
2022-07-10T09:30:00+02:00;4;Oberösterreich;24629848;6312692;18317156
2022-07-10T09:30:00+02:00;5;Salzburg;10672087;3088024;7584063
2022-07-10T09:30:00+02:00;6;Steiermark;21219635;5888399;15331236
2022-07-10T09:30:00+02:00;7;Tirol;9627661;3882827;5744834
2022-07-10T09:30:00+02:00;8;Vorarlberg;7108114;1557025;5551089
2022-07-10T09:30:00+02:00;9;Wien;66507145;58887300;7619845
2022-07-10T09:30:00+02:00;10;Österreich;191428491;97248558;94179933
2022-07-11T09:30:00+02:00;1;Burgenland;5365533;1802218;3563315
2022-07-11T09:30:00+02:00;2;Kärnten;6648981;1543173;5105808
2022-07-11T09:30:00+02:00;3;Niederösterreich;39657940;14295042;25362898
2022-07-11T09:30:00+02:00;4;Oberösterreich;24633883;6315389;18318494
2022-07-11T09:30:00+02:00;5;Salzburg;10673599;3089340;7584259
2022-07-11T09:30:00+02:00;6;Steiermark;21223319;5891683;15331636
2022-07-11T09:30:00+02:00;7;Tirol;9629293;3884459;5744834
2022-07-11T09:30:00+02:00;8;Vorarlberg;7109521;1558106;5551415
2022-07-11T09:30:00+02:00;9;Wien;66550923;58930581;7620342
2022-07-11T09:30:00+02:00;10;Österreich;191492992;97309991;94183001
2022-07-12T09:30:00+02:00;1;Burgenland;5368444;1804686;3563758
2022-07-12T09:30:00+02:00;2;Kärnten;6651629;1545295;5106334
2022-07-12T09:30:00+02:00;3;Niederösterreich;39666179;14301324;25364855
2022-07-12T09:30:00+02:00;4;Oberösterreich;24645247;6319970;18325277
2022-07-12T09:30:00+02:00;5;Salzburg;10683580;3091494;7592086
2022-07-12T09:30:00+02:00;6;Steiermark;21230164;5897019;15333145
2022-07-12T09:30:00+02:00;7;Tirol;9632046;3887212;5744834
2022-07-12T09:30:00+02:00;8;Vorarlberg;7112017;1559754;5552263
2022-07-12T09:30:00+02:00;9;Wien;66613096;58992296;7620800
2022-07-12T09:30:00+02:00;10;Österreich;191602402;97399050;94203352
2022-07-13T09:30:00+02:00;1;Burgenland;5373526;1809566;3563960
2022-07-13T09:30:00+02:00;2;Kärnten;6654282;1546530;5107752
2022-07-13T09:30:00+02:00;3;Niederösterreich;39677515;14308545;25368970
2022-07-13T09:30:00+02:00;4;Oberösterreich;24652052;6323202;18328850
2022-07-13T09:30:00+02:00;5;Salzburg;10686550;3094170;7592380
2022-07-13T09:30:00+02:00;6;Steiermark;21252367;5904832;15347535
2022-07-13T09:30:00+02:00;7;Tirol;9637903;3893069;5744834
2022-07-13T09:30:00+02:00;8;Vorarlberg;7114027;1561136;5552891
2022-07-13T09:30:00+02:00;9;Wien;66675486;59054259;7621227
2022-07-13T09:30:00+02:00;10;Österreich;191723708;97495309;94228399
2022-07-14T09:30:00+02:00;1;Burgenland;5377607;1812885;3564722
2022-07-14T09:30:00+02:00;2;Kärnten;6657085;1548231;5108854
2022-07-14T09:30:00+02:00;3;Niederösterreich;39777639;14352816;25424823
2022-07-14T09:30:00+02:00;4;Oberösterreich;24667330;6326551;18340779
2022-07-14T09:30:00+02:00;5;Salzburg;10688978;3096301;7592677
2022-07-14T09:30:00+02:00;6;Steiermark;21259968;5911277;15348691
2022-07-14T09:30:00+02:00;7;Tirol;9641775;3896941;5744834
2022-07-14T09:30:00+02:00;8;Vorarlberg;7115881;1562375;5553506
2022-07-14T09:30:00+02:00;9;Wien;66719270;59097657;7621613
2022-07-14T09:30:00+02:00;10;Österreich;191905533;97605034;94300499
2022-07-15T09:30:00+02:00;1;Burgenland;5381025;1816053;3564972
2022-07-15T09:30:00+02:00;2;Kärnten;6658579;1549723;5108856
2022-07-15T09:30:00+02:00;3;Niederösterreich;39838742;14357868;25480874
2022-07-15T09:30:00+02:00;4;Oberösterreich;24673597;6330917;18342680
2022-07-15T09:30:00+02:00;5;Salzburg;10691173;3098220;7592953
2022-07-15T09:30:00+02:00;6;Steiermark;21268592;5918759;15349833
2022-07-15T09:30:00+02:00;7;Tirol;9645151;3900317;5744834
2022-07-15T09:30:00+02:00;8;Vorarlberg;7117859;1563586;5554273
2022-07-15T09:30:00+02:00;9;Wien;66785398;59163418;7621980
2022-07-15T09:30:00+02:00;10;Österreich;192060116;97698861;94361255
2022-07-16T09:30:00+02:00;1;Burgenland;5385054;1819345;3565709
2022-07-16T09:30:00+02:00;2;Kärnten;6659413;1550546;5108867
2022-07-16T09:30:00+02:00;3;Niederösterreich;39884068;14364167;25519901
2022-07-16T09:30:00+02:00;4;Oberösterreich;24678989;6334836;18344153
2022-07-16T09:30:00+02:00;5;Salzburg;10693771;3100557;7593214
2022-07-16T09:30:00+02:00;6;Steiermark;21275146;5924325;15350821
2022-07-16T09:30:00+02:00;7;Tirol;9648500;3903666;5744834
2022-07-16T09:30:00+02:00;8;Vorarlberg;7119678;1564912;5554766
2022-07-16T09:30:00+02:00;9;Wien;66830556;59208228;7622328
2022-07-16T09:30:00+02:00;10;Österreich;192175175;97770582;94404593
2022-07-17T09:30:00+02:00;1;Burgenland;5388090;1822227;3565863
2022-07-17T09:30:00+02:00;2;Kärnten;6660190;1551322;5108868
2022-07-17T09:30:00+02:00;3;Niederösterreich;39889826;14369760;25520066
2022-07-17T09:30:00+02:00;4;Oberösterreich;24683122;6338205;18344917
2022-07-17T09:30:00+02:00;5;Salzburg;10695418;3102022;7593396
2022-07-17T09:30:00+02:00;6;Steiermark;21281451;5930167;15351284
2022-07-17T09:30:00+02:00;7;Tirol;9651455;3906621;5744834
2022-07-17T09:30:00+02:00;8;Vorarlberg;7121238;1566214;5555024
2022-07-17T09:30:00+02:00;9;Wien;66870325;59247583;7622742
2022-07-17T09:30:00+02:00;10;Österreich;192241115;97834121;94406994
2022-07-18T09:30:00+02:00;1;Burgenland;5390688;1824814;3565874
2022-07-18T09:30:00+02:00;2;Kärnten;6661424;1552530;5108894
2022-07-18T09:30:00+02:00;3;Niederösterreich;39895021;14374768;25520253
2022-07-18T09:30:00+02:00;4;Oberösterreich;24686881;6340709;18346172
2022-07-18T09:30:00+02:00;5;Salzburg;10697084;3103532;7593552
2022-07-18T09:30:00+02:00;6;Steiermark;21284285;5932648;15351637
2022-07-18T09:30:00+02:00;7;Tirol;9653609;3908775;5744834
2022-07-18T09:30:00+02:00;8;Vorarlberg;7122654;1567366;5555288
2022-07-18T09:30:00+02:00;9;Wien;66907087;59283790;7623297
2022-07-18T09:30:00+02:00;10;Österreich;192298733;97888932;94409801
2022-07-19T09:30:00+02:00;1;Burgenland;5393358;1827138;3566220
2022-07-19T09:30:00+02:00;2;Kärnten;6665291;1554534;5110757
2022-07-19T09:30:00+02:00;3;Niederösterreich;39904081;14381139;25522942
2022-07-19T09:30:00+02:00;4;Oberösterreich;24697987;6345107;18352880
2022-07-19T09:30:00+02:00;5;Salzburg;10715086;3106001;7609085
2022-07-19T09:30:00+02:00;6;Steiermark;21290421;5937277;15353144
2022-07-19T09:30:00+02:00;7;Tirol;9658270;3913436;5744834
2022-07-19T09:30:00+02:00;8;Vorarlberg;7124714;1568600;5556114
2022-07-19T09:30:00+02:00;9;Wien;66969595;59345776;7623819
2022-07-19T09:30:00+02:00;10;Österreich;192418803;97979008;94439795
2022-07-20T09:30:00+02:00;1;Burgenland;5398937;1832049;3566888
2022-07-20T09:30:00+02:00;2;Kärnten;6668335;1555992;5112343
2022-07-20T09:30:00+02:00;3;Niederösterreich;39914099;14385943;25528156
2022-07-20T09:30:00+02:00;4;Oberösterreich;24704808;6348700;18356108
2022-07-20T09:30:00+02:00;5;Salzburg;10716500;3107158;7609342
2022-07-20T09:30:00+02:00;6;Steiermark;21313183;5946283;15366900
2022-07-20T09:30:00+02:00;7;Tirol;9662033;3917199;5744834
2022-07-20T09:30:00+02:00;8;Vorarlberg;7126728;1569994;5556734
2022-07-20T09:30:00+02:00;9;Wien;67028543;59404205;7624338
2022-07-20T09:30:00+02:00;10;Österreich;192533166;98067523;94465643
2022-07-21T09:30:00+02:00;1;Burgenland;5402547;1835288;3567259
2022-07-21T09:30:00+02:00;2;Kärnten;6670359;1558016;5112343
2022-07-21T09:30:00+02:00;3;Niederösterreich;39924726;14393132;25531594
2022-07-21T09:30:00+02:00;4;Oberösterreich;24719530;6351937;18367593
2022-07-21T09:30:00+02:00;5;Salzburg;10718677;3109060;7609617
2022-07-21T09:30:00+02:00;6;Steiermark;21320685;5952673;15368012
2022-07-21T09:30:00+02:00;7;Tirol;9665356;3920522;5744834
2022-07-21T09:30:00+02:00;8;Vorarlberg;7128622;1571313;5557309
2022-07-21T09:30:00+02:00;9;Wien;67083943;59459217;7624726
2022-07-21T09:30:00+02:00;10;Österreich;192634445;98151158;94483287
2022-07-22T09:30:00+02:00;1;Burgenland;5405836;1838237;3567599
2022-07-22T09:30:00+02:00;2;Kärnten;6671499;1559150;5112349
2022-07-22T09:30:00+02:00;3;Niederösterreich;39969762;14436018;25533744
2022-07-22T09:30:00+02:00;4;Oberösterreich;24724960;6355695;18369265
2022-07-22T09:30:00+02:00;5;Salzburg;10721235;3111335;7609900
2022-07-22T09:30:00+02:00;6;Steiermark;21327008;5957953;15369055
2022-07-22T09:30:00+02:00;7;Tirol;9668414;3923580;5744834
2022-07-22T09:30:00+02:00;8;Vorarlberg;7130332;1572549;5557783
2022-07-22T09:30:00+02:00;9;Wien;67134193;59509072;7625121
2022-07-22T09:30:00+02:00;10;Österreich;192753239;98263589;94489650
2022-07-23T09:30:00+02:00;1;Burgenland;5411364;1841466;3569898
2022-07-23T09:30:00+02:00;2;Kärnten;6672461;1560034;5112427
2022-07-23T09:30:00+02:00;3;Niederösterreich;39977620;14441935;25535685
2022-07-23T09:30:00+02:00;4;Oberösterreich;24729909;6359266;18370643
2022-07-23T09:30:00+02:00;5;Salzburg;10722975;3112858;7610117
2022-07-23T09:30:00+02:00;6;Steiermark;21333135;5963234;15369901
2022-07-23T09:30:00+02:00;7;Tirol;9671390;3926556;5744834
2022-07-23T09:30:00+02:00;8;Vorarlberg;7131971;1573593;5558378
2022-07-23T09:30:00+02:00;9;Wien;67182268;59556806;7625462
2022-07-23T09:30:00+02:00;10;Österreich;192833093;98335748;94497345
2022-07-24T09:30:00+02:00;1;Burgenland;5414438;1844499;3569939
2022-07-24T09:30:00+02:00;2;Kärnten;6673285;1560856;5112429
2022-07-24T09:30:00+02:00;3;Niederösterreich;39983787;14447938;25535849
2022-07-24T09:30:00+02:00;4;Oberösterreich;24733921;6362413;18371508
2022-07-24T09:30:00+02:00;5;Salzburg;10725083;3114800;7610283
2022-07-24T09:30:00+02:00;6;Steiermark;21339044;5968705;15370339
2022-07-24T09:30:00+02:00;7;Tirol;9674185;3929351;5744834
2022-07-24T09:30:00+02:00;8;Vorarlberg;7132855;1574217;5558638
2022-07-24T09:30:00+02:00;9;Wien;67218613;59592785;7625828
2022-07-24T09:30:00+02:00;10;Österreich;192895211;98395564;94499647
2022-07-25T09:30:00+02:00;1;Burgenland;5416819;1846840;3569979
2022-07-25T09:30:00+02:00;2;Kärnten;6674704;1562129;5112575
2022-07-25T09:30:00+02:00;3;Niederösterreich;39988578;14452486;25536092
2022-07-25T09:30:00+02:00;4;Oberösterreich;24737570;6364808;18372762
2022-07-25T09:30:00+02:00;5;Salzburg;10726469;3116010;7610459
2022-07-25T09:30:00+02:00;6;Steiermark;21342628;5971929;15370699
2022-07-25T09:30:00+02:00;7;Tirol;9675954;3931120;5744834
2022-07-25T09:30:00+02:00;8;Vorarlberg;7134043;1575108;5558935
2022-07-25T09:30:00+02:00;9;Wien;67250277;59624016;7626261
2022-07-25T09:30:00+02:00;10;Österreich;192947042;98444446;94502596
2022-07-26T09:30:00+02:00;1;Burgenland;5421107;1850490;3570617
2022-07-26T09:30:00+02:00;2;Kärnten;6677623;1564089;5113534
2022-07-26T09:30:00+02:00;3;Niederösterreich;39996701;14458989;25537712
2022-07-26T09:30:00+02:00;4;Oberösterreich;24738745;6365983;18372762
2022-07-26T09:30:00+02:00;5;Salzburg;10743852;3118314;7625538
2022-07-26T09:30:00+02:00;6;Steiermark;21347987;5975839;15372148
2022-07-26T09:30:00+02:00;7;Tirol;9679934;3935100;5744834
2022-07-26T09:30:00+02:00;8;Vorarlberg;7135553;1575919;5559634
2022-07-26T09:30:00+02:00;9;Wien;67308909;59682176;7626733
2022-07-26T09:30:00+02:00;10;Österreich;193050411;98526899;94523512
2022-07-27T09:30:00+02:00;1;Burgenland;5424891;1854078;3570813
2022-07-27T09:30:00+02:00;2;Kärnten;6680843;1565594;5115249
2022-07-27T09:30:00+02:00;3;Niederösterreich;40008148;14465589;25542559
2022-07-27T09:30:00+02:00;4;Oberösterreich;24752661;6371231;18381430
2022-07-27T09:30:00+02:00;5;Salzburg;10745908;3120113;7625795
2022-07-27T09:30:00+02:00;6;Steiermark;21367225;5982768;15384457
2022-07-27T09:30:00+02:00;7;Tirol;9682922;3938088;5744834
2022-07-27T09:30:00+02:00;8;Vorarlberg;7137075;1576924;5560151
2022-07-27T09:30:00+02:00;9;Wien;67363271;59736110;7627161
2022-07-27T09:30:00+02:00;10;Österreich;193162944;98610495;94552449
2022-07-28T09:30:00+02:00;1;Burgenland;5428578;1857643;3570935
2022-07-28T09:30:00+02:00;2;Kärnten;6682550;1567301;5115249
2022-07-28T09:30:00+02:00;3;Niederösterreich;40014472;14470606;25543866
2022-07-28T09:30:00+02:00;4;Oberösterreich;24767991;6373815;18394176
2022-07-28T09:30:00+02:00;5;Salzburg;10748133;3122090;7626043
2022-07-28T09:30:00+02:00;6;Steiermark;21369168;5984377;15384791
2022-07-28T09:30:00+02:00;7;Tirol;9685549;3940715;5744834
2022-07-28T09:30:00+02:00;8;Vorarlberg;7138130;1577530;5560600
2022-07-28T09:30:00+02:00;9;Wien;67410998;59783470;7627528
2022-07-28T09:30:00+02:00;10;Österreich;193245569;98677547;94568022
2022-07-29T09:30:00+02:00;1;Burgenland;5431870;1860587;3571283
2022-07-29T09:30:00+02:00;2;Kärnten;6687719;1568250;5119469
2022-07-29T09:30:00+02:00;3;Niederösterreich;40021893;14476721;25545172
2022-07-29T09:30:00+02:00;4;Oberösterreich;24772810;6376915;18395895
2022-07-29T09:30:00+02:00;5;Salzburg;10750134;3123840;7626294
2022-07-29T09:30:00+02:00;6;Steiermark;21380122;5993621;15386501
2022-07-29T09:30:00+02:00;7;Tirol;9687608;3942774;5744834
2022-07-29T09:30:00+02:00;8;Vorarlberg;7139587;1578190;5561397
2022-07-29T09:30:00+02:00;9;Wien;67455627;59827696;7627931
2022-07-29T09:30:00+02:00;10;Österreich;193327370;98748594;94578776
2022-07-30T09:30:00+02:00;1;Burgenland;5435536;1863595;3571941
2022-07-30T09:30:00+02:00;2;Kärnten;6688509;1569015;5119494
2022-07-30T09:30:00+02:00;3;Niederösterreich;40028986;14482561;25546425
2022-07-30T09:30:00+02:00;4;Oberösterreich;24776830;6379547;18397283
2022-07-30T09:30:00+02:00;5;Salzburg;10751721;3125180;7626541
2022-07-30T09:30:00+02:00;6;Steiermark;21384960;5997606;15387354
2022-07-30T09:30:00+02:00;7;Tirol;9689884;3945050;5744834
2022-07-30T09:30:00+02:00;8;Vorarlberg;7140525;1578753;5561772
2022-07-30T09:30:00+02:00;9;Wien;67497217;59868879;7628338
2022-07-30T09:30:00+02:00;10;Österreich;193394168;98810186;94583982
2022-07-31T09:30:00+02:00;1;Burgenland;5438338;1866231;3572107
2022-07-31T09:30:00+02:00;2;Kärnten;6689261;1569767;5119494
2022-07-31T09:30:00+02:00;3;Niederösterreich;40035500;14488914;25546586
2022-07-31T09:30:00+02:00;4;Oberösterreich;24779626;6381543;18398083
2022-07-31T09:30:00+02:00;5;Salzburg;10752939;3126250;7626689
2022-07-31T09:30:00+02:00;6;Steiermark;21385712;5998183;15387529
2022-07-31T09:30:00+02:00;7;Tirol;9691849;3947015;5744834
2022-07-31T09:30:00+02:00;8;Vorarlberg;7141254;1579293;5561961
2022-07-31T09:30:00+02:00;9;Wien;67529552;59900895;7628657
2022-07-31T09:30:00+02:00;10;Österreich;193444031;98858091;94585940
2022-08-01T09:30:00+02:00;1;Burgenland;5439904;1867748;3572156
2022-08-01T09:30:00+02:00;2;Kärnten;6689958;1570382;5119576
2022-08-01T09:30:00+02:00;3;Niederösterreich;40039754;14492950;25546804
2022-08-01T09:30:00+02:00;4;Oberösterreich;24782536;6383203;18399333
2022-08-01T09:30:00+02:00;5;Salzburg;10754300;3127451;7626849
2022-08-01T09:30:00+02:00;6;Steiermark;21393094;6004862;15388232
2022-08-01T09:30:00+02:00;7;Tirol;9693371;3948537;5744834
2022-08-01T09:30:00+02:00;8;Vorarlberg;7141820;1579666;5562154
2022-08-01T09:30:00+02:00;9;Wien;67560959;59931890;7629069
2022-08-01T09:30:00+02:00;10;Österreich;193495696;98906689;94589007
2022-08-02T09:30:00+02:00;1;Burgenland;5443162;1870612;3572550
2022-08-02T09:30:00+02:00;2;Kärnten;6693361;1572075;5121286
2022-08-02T09:30:00+02:00;3;Niederösterreich;40047037;14497517;25549520
2022-08-02T09:30:00+02:00;4;Oberösterreich;24791930;6385439;18406491
2022-08-02T09:30:00+02:00;5;Salzburg;10770057;3129192;7640865
2022-08-02T09:30:00+02:00;6;Steiermark;21397591;6008103;15389488
2022-08-02T09:30:00+02:00;7;Tirol;9696314;3951480;5744834
2022-08-02T09:30:00+02:00;8;Vorarlberg;7142846;1580129;5562717
2022-08-02T09:30:00+02:00;9;Wien;67615728;59986257;7629471
2022-08-02T09:30:00+02:00;10;Österreich;193598026;98980804;94617222
2022-08-03T09:30:00+02:00;1;Burgenland;5446623;1873686;3572937
2022-08-03T09:30:00+02:00;2;Kärnten;6695948;1573549;5122399
2022-08-03T09:30:00+02:00;3;Niederösterreich;40057375;14503045;25554330
2022-08-03T09:30:00+02:00;4;Oberösterreich;24796644;6388020;18408624
2022-08-03T09:30:00+02:00;5;Salzburg;10764312;3130560;7633752
2022-08-03T09:30:00+02:00;6;Steiermark;21405533;6014434;15391099
2022-08-03T09:30:00+02:00;7;Tirol;9698384;3953550;5744834
2022-08-03T09:30:00+02:00;8;Vorarlberg;7143899;1580629;5563270
2022-08-03T09:30:00+02:00;9;Wien;67662871;60033041;7629830
2022-08-03T09:30:00+02:00;10;Österreich;193671589;99050514;94621075
2022-08-04T09:30:00+02:00;1;Burgenland;5450697;1877494;3573203
2022-08-04T09:30:00+02:00;2;Kärnten;6700916;1575053;5125863
2022-08-04T09:30:00+02:00;3;Niederösterreich;40064733;14508514;25556219
2022-08-04T09:30:00+02:00;4;Oberösterreich;24809235;6390063;18419172
2022-08-04T09:30:00+02:00;5;Salzburg;10765890;3131891;7633999
2022-08-04T09:30:00+02:00;6;Steiermark;21423402;6018876;15404526
2022-08-04T09:30:00+02:00;7;Tirol;9700638;3955804;5744834
2022-08-04T09:30:00+02:00;8;Vorarlberg;7144801;1581142;5563659
2022-08-04T09:30:00+02:00;9;Wien;67705425;60075285;7630140
2022-08-04T09:30:00+02:00;10;Österreich;193765737;99114122;94651615
2022-08-05T09:30:00+02:00;1;Burgenland;5453483;1880234;3573249
2022-08-05T09:30:00+02:00;2;Kärnten;6701651;1575786;5125865
2022-08-05T09:30:00+02:00;3;Niederösterreich;40071127;14513034;25558093
2022-08-05T09:30:00+02:00;4;Oberösterreich;24813114;6392516;18420598
2022-08-05T09:30:00+02:00;5;Salzburg;10767164;3132937;7634227
2022-08-05T09:30:00+02:00;6;Steiermark;21428595;6023126;15405469
2022-08-05T09:30:00+02:00;7;Tirol;9702548;3957714;5744834
2022-08-05T09:30:00+02:00;8;Vorarlberg;7145558;1581544;5564014
2022-08-05T09:30:00+02:00;9;Wien;67747707;60117240;7630467
2022-08-05T09:30:00+02:00;10;Österreich;193830947;99174131;94656816
2022-08-06T09:30:00+02:00;1;Burgenland;5456625;1882845;3573780
2022-08-06T09:30:00+02:00;2;Kärnten;6702198;1576324;5125874
2022-08-06T09:30:00+02:00;3;Niederösterreich;40077996;14518071;25559925
2022-08-06T09:30:00+02:00;4;Oberösterreich;24816386;6394526;18421860
2022-08-06T09:30:00+02:00;5;Salzburg;10768420;3133974;7634446
2022-08-06T09:30:00+02:00;6;Steiermark;21433316;6026967;15406349
2022-08-06T09:30:00+02:00;7;Tirol;9704406;3959572;5744834
2022-08-06T09:30:00+02:00;8;Vorarlberg;7146215;1581901;5564314
2022-08-06T09:30:00+02:00;9;Wien;67786776;60155984;7630792
2022-08-06T09:30:00+02:00;10;Österreich;193892338;99230164;94662174
2022-08-07T09:30:00+02:00;1;Burgenland;5457842;1885026;3572816
2022-08-07T09:30:00+02:00;2;Kärnten;6702396;1576521;5125875
2022-08-07T09:30:00+02:00;3;Niederösterreich;40082345;14522262;25560083
2022-08-07T09:30:00+02:00;4;Oberösterreich;24818790;6396075;18422715
2022-08-07T09:30:00+02:00;5;Salzburg;10769423;3134815;7634608
2022-08-07T09:30:00+02:00;6;Steiermark;21437786;6031045;15406741
2022-08-07T09:30:00+02:00;7;Tirol;9706274;3961440;5744834
2022-08-07T09:30:00+02:00;8;Vorarlberg;7146873;1582352;5564521
2022-08-07T09:30:00+02:00;9;Wien;67813878;60182763;7631115
2022-08-07T09:30:00+02:00;10;Österreich;193935607;99272299;94663308
2022-08-08T09:30:00+02:00;1;Burgenland;5460710;1886869;3573841
2022-08-08T09:30:00+02:00;2;Kärnten;6703539;1577644;5125895
2022-08-08T09:30:00+02:00;3;Niederösterreich;40085903;14525597;25560306
2022-08-08T09:30:00+02:00;4;Oberösterreich;24821600;6397546;18424054
2022-08-08T09:30:00+02:00;5;Salzburg;10770393;3135612;7634781
2022-08-08T09:30:00+02:00;6;Steiermark;21440447;6033390;15407057
2022-08-08T09:30:00+02:00;7;Tirol;9707379;3962545;5744834
2022-08-08T09:30:00+02:00;8;Vorarlberg;7147432;1582708;5564724
2022-08-08T09:30:00+02:00;9;Wien;67813878;60182763;7631115
2022-08-08T09:30:00+02:00;10;Österreich;193951281;99284674;94666607
2022-08-09T09:30:00+02:00;1;Burgenland;5463047;1889042;3574005
2022-08-09T09:30:00+02:00;2;Kärnten;6706392;1579536;5126856
2022-08-09T09:30:00+02:00;3;Niederösterreich;40093351;14530022;25563329
2022-08-09T09:30:00+02:00;4;Oberösterreich;24828664;6399669;18428995
2022-08-09T09:30:00+02:00;5;Salzburg;10778754;3137034;7641720
2022-08-09T09:30:00+02:00;6;Steiermark;21453483;6036792;15416691
2022-08-09T09:30:00+02:00;7;Tirol;9708489;3963655;5744834
2022-08-09T09:30:00+02:00;8;Vorarlberg;7148141;1582854;5565287
2022-08-09T09:30:00+02:00;9;Wien;67887487;60255662;7631825
2022-08-09T09:30:00+02:00;10;Österreich;194067808;99374266;94693542
2022-08-10T09:30:00+02:00;1;Burgenland;5467146;1892929;3574217
2022-08-10T09:30:00+02:00;2;Kärnten;6709528;1580572;5128956
2022-08-10T09:30:00+02:00;3;Niederösterreich;40100776;14532984;25567792
2022-08-10T09:30:00+02:00;4;Oberösterreich;24834405;6401475;18432930
2022-08-10T09:30:00+02:00;5;Salzburg;10780094;3138117;7641977
2022-08-10T09:30:00+02:00;6;Steiermark;21471878;6042765;15429113
2022-08-10T09:30:00+02:00;7;Tirol;9712234;3967400;5744834
2022-08-10T09:30:00+02:00;8;Vorarlberg;7149055;1583359;5565696
2022-08-10T09:30:00+02:00;9;Wien;67933060;60300938;7632122
2022-08-10T09:30:00+02:00;10;Österreich;194158176;99440539;94717637
2022-08-11T09:30:00+02:00;1;Burgenland;5469728;1895354;3574374
2022-08-11T09:30:00+02:00;2;Kärnten;6710491;1581529;5128962
2022-08-11T09:30:00+02:00;3;Niederösterreich;40106757;14537535;25569222
2022-08-11T09:30:00+02:00;4;Oberösterreich;24849502;6403236;18446266
2022-08-11T09:30:00+02:00;5;Salzburg;10781715;3139485;7642230
2022-08-11T09:30:00+02:00;6;Steiermark;21476881;6046800;15430081
2022-08-11T09:30:00+02:00;7;Tirol;9713552;3968718;5744834
2022-08-11T09:30:00+02:00;8;Vorarlberg;7150058;1583840;5566218
2022-08-11T09:30:00+02:00;9;Wien;67973695;60341223;7632472
2022-08-11T09:30:00+02:00;10;Österreich;194232379;99497720;94734659
2022-08-12T09:30:00+02:00;1;Burgenland;5472465;1897831;3574634
2022-08-12T09:30:00+02:00;2;Kärnten;6712921;1582345;5130576
2022-08-12T09:30:00+02:00;3;Niederösterreich;40111965;14541403;25570562
2022-08-12T09:30:00+02:00;4;Oberösterreich;24853490;6405562;18447928
2022-08-12T09:30:00+02:00;5;Salzburg;10783017;3140546;7642471
2022-08-12T09:30:00+02:00;6;Steiermark;21482418;6051406;15431012
2022-08-12T09:30:00+02:00;7;Tirol;9716103;3971269;5744834
2022-08-12T09:30:00+02:00;8;Vorarlberg;7151018;1584307;5566711
2022-08-12T09:30:00+02:00;9;Wien;68015353;60382541;7632812
2022-08-12T09:30:00+02:00;10;Österreich;194298750;99557210;94741540
2022-08-13T09:30:00+02:00;1;Burgenland;5474896;1900171;3574725
2022-08-13T09:30:00+02:00;2;Kärnten;6713538;1582962;5130576
2022-08-13T09:30:00+02:00;3;Niederösterreich;40117431;14545551;25571880
2022-08-13T09:30:00+02:00;4;Oberösterreich;24856828;6407511;18449317
2022-08-13T09:30:00+02:00;5;Salzburg;10784129;3141432;7642697
2022-08-13T09:30:00+02:00;6;Steiermark;21486967;6055103;15431864
2022-08-13T09:30:00+02:00;7;Tirol;9717862;3973028;5744834
2022-08-13T09:30:00+02:00;8;Vorarlberg;7151738;1584717;5567021
2022-08-13T09:30:00+02:00;9;Wien;68053838;60420712;7633126
2022-08-13T09:30:00+02:00;10;Österreich;194357227;99611187;94746040
2022-08-14T09:30:00+02:00;1;Burgenland;5477267;1902403;3574864
2022-08-14T09:30:00+02:00;2;Kärnten;6714077;1583498;5130579
2022-08-14T09:30:00+02:00;3;Niederösterreich;40121010;14548977;25572033
2022-08-14T09:30:00+02:00;4;Oberösterreich;24859077;6408878;18450199
2022-08-14T09:30:00+02:00;5;Salzburg;10785061;3142220;7642841
2022-08-14T09:30:00+02:00;6;Steiermark;21491452;6059160;15432292
2022-08-14T09:30:00+02:00;7;Tirol;9719418;3974584;5744834
2022-08-14T09:30:00+02:00;8;Vorarlberg;7152328;1585088;5567240
2022-08-14T09:30:00+02:00;9;Wien;68078931;60445475;7633456
2022-08-14T09:30:00+02:00;10;Österreich;194398621;99650283;94748338
2022-08-15T09:30:00+02:00;1;Burgenland;5478791;1903894;3574897
2022-08-15T09:30:00+02:00;2;Kärnten;6714315;1583736;5130579
2022-08-15T09:30:00+02:00;3;Niederösterreich;40123680;14551452;25572228
2022-08-15T09:30:00+02:00;4;Oberösterreich;24861205;6410091;18451114
2022-08-15T09:30:00+02:00;5;Salzburg;10785920;3142941;7642979
2022-08-15T09:30:00+02:00;6;Steiermark;21493246;6060703;15432543
2022-08-15T09:30:00+02:00;7;Tirol;9720433;3975599;5744834
2022-08-15T09:30:00+02:00;8;Vorarlberg;7152818;1585425;5567393
2022-08-15T09:30:00+02:00;9;Wien;68099495;60465712;7633783
2022-08-15T09:30:00+02:00;10;Österreich;194429903;99679553;94750350
2022-08-16T09:30:00+02:00;1;Burgenland;5480264;1905330;3574934
2022-08-16T09:30:00+02:00;2;Kärnten;6715526;1584779;5130747
2022-08-16T09:30:00+02:00;3;Niederösterreich;40127984;14554547;25573437
2022-08-16T09:30:00+02:00;4;Oberösterreich;24864806;6412154;18452652
2022-08-16T09:30:00+02:00;5;Salzburg;10786916;3143715;7643201
2022-08-16T09:30:00+02:00;6;Steiermark;21495175;6062143;15433032
2022-08-16T09:30:00+02:00;7;Tirol;9721700;3976866;5744834
2022-08-16T09:30:00+02:00;8;Vorarlberg;7153329;1585683;5567646
2022-08-16T09:30:00+02:00;9;Wien;68128010;60493857;7634153
2022-08-16T09:30:00+02:00;10;Österreich;194473710;99719074;94754636
2022-08-17T09:30:00+02:00;1;Burgenland;5484545;1907829;3576716
2022-08-17T09:30:00+02:00;2;Kärnten;6718862;1587022;5131840
2022-08-17T09:30:00+02:00;3;Niederösterreich;40135299;14558392;25576907
2022-08-17T09:30:00+02:00;4;Oberösterreich;24874151;6414207;18459944
2022-08-17T09:30:00+02:00;5;Salzburg;10794993;3145068;7649925
2022-08-17T09:30:00+02:00;6;Steiermark;21508792;6065218;15443574
2022-08-17T09:30:00+02:00;7;Tirol;9724392;3979558;5744834
2022-08-17T09:30:00+02:00;8;Vorarlberg;7154444;1586019;5568425
2022-08-17T09:30:00+02:00;9;Wien;68178379;60543783;7634596
2022-08-17T09:30:00+02:00;10;Österreich;194573857;99787096;94786761
2022-08-18T09:30:00+02:00;1;Burgenland;5488606;1911551;3577055
2022-08-18T09:30:00+02:00;2;Kärnten;6721224;1588700;5132524
2022-08-18T09:30:00+02:00;3;Niederösterreich;40140211;14562098;25578113
2022-08-18T09:30:00+02:00;4;Oberösterreich;24885204;6415858;18469346
2022-08-18T09:30:00+02:00;5;Salzburg;10796587;3146395;7650192
2022-08-18T09:30:00+02:00;6;Steiermark;21517391;6072680;15444711
2022-08-18T09:30:00+02:00;7;Tirol;9726506;3981672;5744834
2022-08-18T09:30:00+02:00;8;Vorarlberg;7155419;1586556;5568863
2022-08-18T09:30:00+02:00;9;Wien;68223259;60588335;7634924
2022-08-18T09:30:00+02:00;10;Österreich;194654407;99853845;94800562
2022-08-19T09:30:00+02:00;1;Burgenland;5491572;1913814;3577758
2022-08-19T09:30:00+02:00;2;Kärnten;6725025;1589580;5135445
2022-08-19T09:30:00+02:00;3;Niederösterreich;40144267;14565177;25579090
2022-08-19T09:30:00+02:00;4;Oberösterreich;24888722;6417454;18471268
2022-08-19T09:30:00+02:00;5;Salzburg;10797897;3147473;7650424
2022-08-19T09:30:00+02:00;6;Steiermark;21522572;6076805;15445767
2022-08-19T09:30:00+02:00;7;Tirol;9728204;3983370;5744834
2022-08-19T09:30:00+02:00;8;Vorarlberg;7156307;1587000;5569307
2022-08-19T09:30:00+02:00;9;Wien;68262725;60627553;7635172
2022-08-19T09:30:00+02:00;10;Österreich;194717291;99908226;94809065
2022-08-20T09:30:00+02:00;1;Burgenland;5496392;1916104;3580288
2022-08-20T09:30:00+02:00;2;Kärnten;6725664;1590206;5135458
2022-08-20T09:30:00+02:00;3;Niederösterreich;40148062;14568022;25580040
2022-08-20T09:30:00+02:00;4;Oberösterreich;24893026;6420254;18472772
2022-08-20T09:30:00+02:00;5;Salzburg;10799034;3148402;7650632
2022-08-20T09:30:00+02:00;6;Steiermark;21527554;6080858;15446696
2022-08-20T09:30:00+02:00;7;Tirol;9729961;3985127;5744834
2022-08-20T09:30:00+02:00;8;Vorarlberg;7157051;1587441;5569610
2022-08-20T09:30:00+02:00;9;Wien;68295069;60659574;7635495
2022-08-20T09:30:00+02:00;10;Österreich;194771813;99955988;94815825
2022-08-21T09:30:00+02:00;1;Burgenland;5498718;1918410;3580308
2022-08-21T09:30:00+02:00;2;Kärnten;6726181;1590723;5135458
2022-08-21T09:30:00+02:00;3;Niederösterreich;40152186;14571986;25580200
2022-08-21T09:30:00+02:00;4;Oberösterreich;24895370;6421660;18473710
2022-08-21T09:30:00+02:00;5;Salzburg;10800096;3149324;7650772
2022-08-21T09:30:00+02:00;6;Steiermark;21532279;6085164;15447115
2022-08-21T09:30:00+02:00;7;Tirol;9731457;3986623;5744834
2022-08-21T09:30:00+02:00;8;Vorarlberg;7157609;1587831;5569778
2022-08-21T09:30:00+02:00;9;Wien;68324436;60688676;7635760
2022-08-21T09:30:00+02:00;10;Österreich;194818332;100000397;94817935
2022-08-22T09:30:00+02:00;1;Burgenland;5500651;1920235;3580416
2022-08-22T09:30:00+02:00;2;Kärnten;6727095;1591637;5135458
2022-08-22T09:30:00+02:00;3;Niederösterreich;40154935;14574530;25580405
2022-08-22T09:30:00+02:00;4;Oberösterreich;24898338;6423140;18475198
2022-08-22T09:30:00+02:00;5;Salzburg;10800980;3149993;7650987
2022-08-22T09:30:00+02:00;6;Steiermark;21534576;6087060;15447516
2022-08-22T09:30:00+02:00;7;Tirol;9732492;3987658;5744834
2022-08-22T09:30:00+02:00;8;Vorarlberg;7158120;1588185;5569935
2022-08-22T09:30:00+02:00;9;Wien;68349784;60713685;7636099
2022-08-22T09:30:00+02:00;10;Österreich;194856971;100036123;94820848
2022-08-23T09:30:00+02:00;1;Burgenland;5503731;1922856;3580875
2022-08-23T09:30:00+02:00;2;Kärnten;6729633;1593381;5136252
2022-08-23T09:30:00+02:00;3;Niederösterreich;40160381;14578267;25582114
2022-08-23T09:30:00+02:00;4;Oberösterreich;24906836;6425288;18481548
2022-08-23T09:30:00+02:00;5;Salzburg;10808801;3151331;7657470
2022-08-23T09:30:00+02:00;6;Steiermark;21538931;6089827;15449104
2022-08-23T09:30:00+02:00;7;Tirol;9734873;3990039;5744834
2022-08-23T09:30:00+02:00;8;Vorarlberg;7159086;1588532;5570554
2022-08-23T09:30:00+02:00;9;Wien;68398000;60761566;7636434
2022-08-23T09:30:00+02:00;10;Österreich;194940272;100101087;94839185
2022-08-24T09:30:00+02:00;1;Burgenland;5507033;1925969;3581064
2022-08-24T09:30:00+02:00;2;Kärnten;6731531;1594253;5137278
2022-08-24T09:30:00+02:00;3;Niederösterreich;40166179;14581889;25584290
2022-08-24T09:30:00+02:00;4;Oberösterreich;24932796;6427014;18505782
2022-08-24T09:30:00+02:00;5;Salzburg;10810268;3152527;7657741
2022-08-24T09:30:00+02:00;6;Steiermark;21559360;6095578;15463782
2022-08-24T09:30:00+02:00;7;Tirol;9736837;3992003;5744834
2022-08-24T09:30:00+02:00;8;Vorarlberg;7160020;1589042;5570978
2022-08-24T09:30:00+02:00;9;Wien;68443284;60806601;7636683
2022-08-24T09:30:00+02:00;10;Österreich;195047308;100164876;94882432
2022-08-25T09:30:00+02:00;1;Burgenland;5510520;1928374;3582146
2022-08-25T09:30:00+02:00;2;Kärnten;6732884;1595606;5137278
2022-08-25T09:30:00+02:00;3;Niederösterreich;40174347;14585545;25588802
2022-08-25T09:30:00+02:00;4;Oberösterreich;24948025;6429017;18519008
2022-08-25T09:30:00+02:00;5;Salzburg;10811497;3153469;7658028
2022-08-25T09:30:00+02:00;6;Steiermark;21565181;6100260;15464921
2022-08-25T09:30:00+02:00;7;Tirol;9738747;3993913;5744834
2022-08-25T09:30:00+02:00;8;Vorarlberg;7160835;1589439;5571396
2022-08-25T09:30:00+02:00;9;Wien;68483331;60846386;7636945
2022-08-25T09:30:00+02:00;10;Österreich;195125367;100222009;94903358
2022-08-26T09:30:00+02:00;1;Burgenland;5513239;1930827;3582412
2022-08-26T09:30:00+02:00;2;Kärnten;6735050;1596350;5138700
2022-08-26T09:30:00+02:00;3;Niederösterreich;40178873;14588447;25590426
2022-08-26T09:30:00+02:00;4;Oberösterreich;24952740;6431691;18521049
2022-08-26T09:30:00+02:00;5;Salzburg;10812811;3154513;7658298
2022-08-26T09:30:00+02:00;6;Steiermark;21570819;6104808;15466011
2022-08-26T09:30:00+02:00;7;Tirol;9740382;3995548;5744834
2022-08-26T09:30:00+02:00;8;Vorarlberg;7161617;1589837;5571780
2022-08-26T09:30:00+02:00;9;Wien;68521657;60884436;7637221
2022-08-26T09:30:00+02:00;10;Österreich;195187188;100276457;94910731
2022-08-27T09:30:00+02:00;1;Burgenland;5516401;1933199;3583202
2022-08-27T09:30:00+02:00;2;Kärnten;6735633;1596922;5138711
2022-08-27T09:30:00+02:00;3;Niederösterreich;40184297;14592209;25592088
2022-08-27T09:30:00+02:00;4;Oberösterreich;24956520;6433715;18522805
2022-08-27T09:30:00+02:00;5;Salzburg;10813884;3155331;7658553
2022-08-27T09:30:00+02:00;6;Steiermark;21575651;6108659;15466992
2022-08-27T09:30:00+02:00;7;Tirol;9741999;3997165;5744834
2022-08-27T09:30:00+02:00;8;Vorarlberg;7162391;1590204;5572187
2022-08-27T09:30:00+02:00;9;Wien;68557784;60920239;7637545
2022-08-27T09:30:00+02:00;10;Österreich;195244560;100327643;94916917
2022-08-28T09:30:00+02:00;1;Burgenland;5518465;1935166;3583299
2022-08-28T09:30:00+02:00;2;Kärnten;6736252;1597541;5138711
2022-08-28T09:30:00+02:00;3;Niederösterreich;40187937;14595673;25592264
2022-08-28T09:30:00+02:00;4;Oberösterreich;24959204;6435469;18523735
2022-08-28T09:30:00+02:00;5;Salzburg;10814836;3156110;7658726
2022-08-28T09:30:00+02:00;6;Steiermark;21580716;6113301;15467415
2022-08-28T09:30:00+02:00;7;Tirol;9743501;3998667;5744834
2022-08-28T09:30:00+02:00;8;Vorarlberg;7162896;1590550;5572346
2022-08-28T09:30:00+02:00;9;Wien;68582489;60944700;7637789
2022-08-28T09:30:00+02:00;10;Österreich;195286296;100367177;94919119
2022-08-29T09:30:00+02:00;1;Burgenland;5520219;1936860;3583359
2022-08-29T09:30:00+02:00;2;Kärnten;6737114;1598403;5138711
2022-08-29T09:30:00+02:00;3;Niederösterreich;40190517;14598061;25592456
2022-08-29T09:30:00+02:00;4;Oberösterreich;24962086;6436749;18525337
2022-08-29T09:30:00+02:00;5;Salzburg;10815691;3156787;7658904
2022-08-29T09:30:00+02:00;6;Steiermark;21582546;6114728;15467818
2022-08-29T09:30:00+02:00;7;Tirol;9744583;3999749;5744834
2022-08-29T09:30:00+02:00;8;Vorarlberg;7163489;1590929;5572560
2022-08-29T09:30:00+02:00;9;Wien;68606715;60968632;7638083
2022-08-29T09:30:00+02:00;10;Österreich;195322960;100400898;94922062
2022-08-30T09:30:00+02:00;1;Burgenland;5524664;1939585;3585079
2022-08-30T09:30:00+02:00;2;Kärnten;6740556;1599834;5140722
2022-08-30T09:30:00+02:00;3;Niederösterreich;40196114;14602157;25593957
2022-08-30T09:30:00+02:00;4;Oberösterreich;24970528;6438749;18531779
2022-08-30T09:30:00+02:00;5;Salzburg;10823784;3158005;7665779
2022-08-30T09:30:00+02:00;6;Steiermark;21587056;6117699;15469357
2022-08-30T09:30:00+02:00;7;Tirol;9747182;4002348;5744834
2022-08-30T09:30:00+02:00;8;Vorarlberg;7164467;1591211;5573256
2022-08-30T09:30:00+02:00;9;Wien;68655830;61017433;7638397
2022-08-30T09:30:00+02:00;10;Österreich;195410181;100467021;94943160
2022-08-31T09:30:00+02:00;1;Burgenland;5528320;1942619;3585701
2022-08-31T09:30:00+02:00;2;Kärnten;6742322;1600895;5141427
2022-08-31T09:30:00+02:00;3;Niederösterreich;40201742;14606140;25595602
2022-08-31T09:30:00+02:00;4;Oberösterreich;24976079;6440818;18535261
2022-08-31T09:30:00+02:00;5;Salzburg;10825240;3159179;7666061
2022-08-31T09:30:00+02:00;6;Steiermark;21607277;6123396;15483881
2022-08-31T09:30:00+02:00;7;Tirol;9749103;4004269;5744834
2022-08-31T09:30:00+02:00;8;Vorarlberg;7165469;1591687;5573782
2022-08-31T09:30:00+02:00;9;Wien;68700674;61061978;7638696
2022-08-31T09:30:00+02:00;10;Österreich;195496226;100530981;94965245
2022-09-01T09:30:00+02:00;1;Burgenland;5531223;1945275;3585948
2022-09-01T09:30:00+02:00;2;Kärnten;6743726;1602297;5141429
2022-09-01T09:30:00+02:00;3;Niederösterreich;40207375;14609927;25597448
2022-09-01T09:30:00+02:00;4;Oberösterreich;24988498;6442382;18546116
2022-09-01T09:30:00+02:00;5;Salzburg;10826520;3160148;7666372
2022-09-01T09:30:00+02:00;6;Steiermark;21612604;6127511;15485093
2022-09-01T09:30:00+02:00;7;Tirol;9750924;4006090;5744834
2022-09-01T09:30:00+02:00;8;Vorarlberg;7166269;1592076;5574193
2022-09-01T09:30:00+02:00;9;Wien;68740776;61101801;7638975
2022-09-01T09:30:00+02:00;10;Österreich;195567915;100587507;94980408
2022-09-02T09:30:00+02:00;1;Burgenland;5533576;1947584;3585992
2022-09-02T09:30:00+02:00;2;Kärnten;6745555;1603057;5142498
2022-09-02T09:30:00+02:00;3;Niederösterreich;40214618;14612618;25602000
2022-09-02T09:30:00+02:00;4;Oberösterreich;24992947;6444668;18548279
2022-09-02T09:30:00+02:00;5;Salzburg;10827745;3161094;7666651
2022-09-02T09:30:00+02:00;6;Steiermark;21618278;6132070;15486208
2022-09-02T09:30:00+02:00;7;Tirol;9752633;4007799;5744834
2022-09-02T09:30:00+02:00;8;Vorarlberg;7167027;1592451;5574576
2022-09-02T09:30:00+02:00;9;Wien;68782493;61143260;7639233
2022-09-02T09:30:00+02:00;10;Österreich;195634872;100644601;94990271
2022-09-03T09:30:00+02:00;1;Burgenland;5537612;1949964;3587648
2022-09-03T09:30:00+02:00;2;Kärnten;6746013;1603499;5142514
2022-09-03T09:30:00+02:00;3;Niederösterreich;40219947;14616564;25603383
2022-09-03T09:30:00+02:00;4;Oberösterreich;24996862;6446865;18549997
2022-09-03T09:30:00+02:00;5;Salzburg;10828628;3161749;7666879
2022-09-03T09:30:00+02:00;6;Steiermark;21622768;6135631;15487137
2022-09-03T09:30:00+02:00;7;Tirol;9754010;4009176;5744834
2022-09-03T09:30:00+02:00;8;Vorarlberg;7167722;1592830;5574892
2022-09-03T09:30:00+02:00;9;Wien;68818049;61178560;7639489
2022-09-03T09:30:00+02:00;10;Österreich;195691611;100694838;94996773
2022-09-04T09:30:00+02:00;1;Burgenland;5540012;1952258;3587754
2022-09-04T09:30:00+02:00;2;Kärnten;6746475;1603961;5142514
2022-09-04T09:30:00+02:00;3;Niederösterreich;40223550;14619997;25603553
2022-09-04T09:30:00+02:00;4;Oberösterreich;24999448;6448545;18550903
2022-09-04T09:30:00+02:00;5;Salzburg;10829599;3162598;7667001
2022-09-04T09:30:00+02:00;6;Steiermark;21627127;6139624;15487503
2022-09-04T09:30:00+02:00;7;Tirol;9755375;4010541;5744834
2022-09-04T09:30:00+02:00;8;Vorarlberg;7168272;1593210;5575062
2022-09-04T09:30:00+02:00;9;Wien;68852238;61212516;7639722
2022-09-04T09:30:00+02:00;10;Österreich;195742096;100743250;94998846
2022-09-05T09:30:00+02:00;1;Burgenland;5542720;1954902;3587818
2022-09-05T09:30:00+02:00;2;Kärnten;6747426;1604867;5142559
2022-09-05T09:30:00+02:00;3;Niederösterreich;40226903;14622922;25603981
2022-09-05T09:30:00+02:00;4;Oberösterreich;25002524;6449998;18552526
2022-09-05T09:30:00+02:00;5;Salzburg;10830395;3163209;7667186
2022-09-05T09:30:00+02:00;6;Steiermark;21629364;6141427;15487937
2022-09-05T09:30:00+02:00;7;Tirol;9756234;4011400;5744834
2022-09-05T09:30:00+02:00;8;Vorarlberg;7168784;1593535;5575249
2022-09-05T09:30:00+02:00;9;Wien;68928268;61287987;7640281
2022-09-05T09:30:00+02:00;10;Österreich;195832618;100830247;95002371
2022-09-06T09:30:00+02:00;1;Burgenland;5546821;1958682;3588139
2022-09-06T09:30:00+02:00;2;Kärnten;6749264;1606367;5142897
2022-09-06T09:30:00+02:00;3;Niederösterreich;40234583;14626699;25607884
2022-09-06T09:30:00+02:00;4;Oberösterreich;25022356;6452070;18570286
2022-09-06T09:30:00+02:00;5;Salzburg;10838281;3164384;7673897
2022-09-06T09:30:00+02:00;6;Steiermark;21634133;6144521;15489612
2022-09-06T09:30:00+02:00;7;Tirol;9758592;4013758;5744834
2022-09-06T09:30:00+02:00;8;Vorarlberg;7169710;1593802;5575908
2022-09-06T09:30:00+02:00;9;Wien;69012510;61371836;7640674
2022-09-06T09:30:00+02:00;10;Österreich;195966250;100932119;95034131
2022-09-07T09:30:00+02:00;1;Burgenland;5550309;1961482;3588827
2022-09-07T09:30:00+02:00;2;Kärnten;6750227;1606956;5143271
2022-09-07T09:30:00+02:00;3;Niederösterreich;40239480;14629677;25609803
2022-09-07T09:30:00+02:00;4;Oberösterreich;25028770;6453809;18574961
2022-09-07T09:30:00+02:00;5;Salzburg;10839632;3165436;7674196
2022-09-07T09:30:00+02:00;6;Steiermark;21653682;6151228;15502454
2022-09-07T09:30:00+02:00;7;Tirol;9760324;4015490;5744834
2022-09-07T09:30:00+02:00;8;Vorarlberg;7170713;1594259;5576454
2022-09-07T09:30:00+02:00;9;Wien;69056241;61415300;7640941
2022-09-07T09:30:00+02:00;10;Österreich;196049378;100993637;95055741
2022-09-08T09:30:00+02:00;1;Burgenland;5553495;1964106;3589389
2022-09-08T09:30:00+02:00;2;Kärnten;6753173;1608466;5144707
2022-09-08T09:30:00+02:00;3;Niederösterreich;40247109;14636152;25610957
2022-09-08T09:30:00+02:00;4;Oberösterreich;25042835;6455586;18587249
2022-09-08T09:30:00+02:00;5;Salzburg;10840927;3166430;7674497
2022-09-08T09:30:00+02:00;6;Steiermark;21659074;6155377;15503697
2022-09-08T09:30:00+02:00;7;Tirol;9762018;4017184;5744834
2022-09-08T09:30:00+02:00;8;Vorarlberg;7171529;1594649;5576880
2022-09-08T09:30:00+02:00;9;Wien;69096055;61454876;7641179
2022-09-08T09:30:00+02:00;10;Österreich;196126215;101052826;95073389
2022-09-09T09:30:00+02:00;1;Burgenland;5556059;1966460;3589599
2022-09-09T09:30:00+02:00;2;Kärnten;6755375;1609189;5146186
2022-09-09T09:30:00+02:00;3;Niederösterreich;40252513;14639985;25612528
2022-09-09T09:30:00+02:00;4;Oberösterreich;25047632;6458170;18589462
2022-09-09T09:30:00+02:00;5;Salzburg;10842149;3167364;7674785
2022-09-09T09:30:00+02:00;6;Steiermark;21666810;6161988;15504822
2022-09-09T09:30:00+02:00;7;Tirol;9763401;4018567;5744834
2022-09-09T09:30:00+02:00;8;Vorarlberg;7172349;1595031;5577318
2022-09-09T09:30:00+02:00;9;Wien;69096055;61454876;7641179
2022-09-09T09:30:00+02:00;10;Österreich;196152343;101071630;95080713
2022-09-10T09:30:00+02:00;1;Burgenland;5559855;1968819;3591036
2022-09-10T09:30:00+02:00;2;Kärnten;6755895;1609689;5146206
2022-09-10T09:30:00+02:00;3;Niederösterreich;40258228;14644415;25613813
2022-09-10T09:30:00+02:00;4;Oberösterreich;25051289;6459984;18591305
2022-09-10T09:30:00+02:00;5;Salzburg;10843361;3168319;7675042
2022-09-10T09:30:00+02:00;6;Steiermark;21677877;6165944;15511933
2022-09-10T09:30:00+02:00;7;Tirol;9765314;4020480;5744834
2022-09-10T09:30:00+02:00;8;Vorarlberg;7173127;1595382;5577745
2022-09-10T09:30:00+02:00;9;Wien;69173992;61532309;7641683
2022-09-10T09:30:00+02:00;10;Österreich;196258938;101165341;95093597
2022-09-11T09:30:00+02:00;1;Burgenland;5562089;1970921;3591168
2022-09-11T09:30:00+02:00;2;Kärnten;6756605;1610399;5146206
2022-09-11T09:30:00+02:00;3;Niederösterreich;40261240;14647195;25614045
2022-09-11T09:30:00+02:00;4;Oberösterreich;25053919;6461646;18592273
2022-09-11T09:30:00+02:00;5;Salzburg;10844460;3169261;7675199
2022-09-11T09:30:00+02:00;6;Steiermark;21685453;6173042;15512411
2022-09-11T09:30:00+02:00;7;Tirol;9768155;4023321;5744834
2022-09-11T09:30:00+02:00;8;Vorarlberg;7173705;1595756;5577949
2022-09-11T09:30:00+02:00;9;Wien;69199973;61558099;7641874
2022-09-11T09:30:00+02:00;10;Österreich;196305599;101209640;95095959
2022-09-12T09:30:00+02:00;1;Burgenland;5563966;1972632;3591334
2022-09-12T09:30:00+02:00;2;Kärnten;6757519;1610992;5146527
2022-09-12T09:30:00+02:00;3;Niederösterreich;40264193;14649970;25614223
2022-09-12T09:30:00+02:00;4;Oberösterreich;25056272;6463102;18593170
2022-09-12T09:30:00+02:00;5;Salzburg;10845519;3169947;7675572
2022-09-12T09:30:00+02:00;6;Steiermark;21689657;6176540;15513117
2022-09-12T09:30:00+02:00;7;Tirol;9769337;4024503;5744834
2022-09-12T09:30:00+02:00;8;Vorarlberg;7174294;1596091;5578203
2022-09-12T09:30:00+02:00;9;Wien;69225161;61582992;7642169
2022-09-12T09:30:00+02:00;10;Österreich;196345918;101246769;95099149
2022-09-13T09:30:00+02:00;1;Burgenland;5566405;1974723;3591682
2022-09-13T09:30:00+02:00;2;Kärnten;6765111;1613560;5151551
2022-09-13T09:30:00+02:00;3;Niederösterreich;40269515;14653534;25615981
2022-09-13T09:30:00+02:00;4;Oberösterreich;25066943;6465975;18600968
2022-09-13T09:30:00+02:00;5;Salzburg;10853816;3171262;7682554
2022-09-13T09:30:00+02:00;6;Steiermark;21693608;6179319;15514289
2022-09-13T09:30:00+02:00;7;Tirol;9771941;4027107;5744834
2022-09-13T09:30:00+02:00;8;Vorarlberg;7175133;1596302;5578831
2022-09-13T09:30:00+02:00;9;Wien;69288724;61646250;7642474
2022-09-13T09:30:00+02:00;10;Österreich;196451196;101328032;95123164
2022-09-14T09:30:00+02:00;1;Burgenland;5570603;1978625;3591978
2022-09-14T09:30:00+02:00;2;Kärnten;6767859;1614789;5153070
2022-09-14T09:30:00+02:00;3;Niederösterreich;40278261;14657670;25620591
2022-09-14T09:30:00+02:00;4;Oberösterreich;25073992;6469009;18604983
2022-09-14T09:30:00+02:00;5;Salzburg;10855542;3172658;7682884
2022-09-14T09:30:00+02:00;6;Steiermark;21700505;6185386;15515119
2022-09-14T09:30:00+02:00;7;Tirol;9773761;4028927;5744834
2022-09-14T09:30:00+02:00;8;Vorarlberg;7176167;1596821;5579346
2022-09-14T09:30:00+02:00;9;Wien;69332636;61689873;7642763
2022-09-14T09:30:00+02:00;10;Österreich;196529326;101393758;95135568
2022-09-15T09:30:00+02:00;1;Burgenland;5573539;1981255;3592284
2022-09-15T09:30:00+02:00;2;Kärnten;6769144;1616074;5153070
2022-09-15T09:30:00+02:00;3;Niederösterreich;40283892;14661693;25622199
2022-09-15T09:30:00+02:00;4;Oberösterreich;25078728;6471215;18607513
2022-09-15T09:30:00+02:00;5;Salzburg;10856912;3173695;7683217
2022-09-15T09:30:00+02:00;6;Steiermark;21705455;6189519;15515936
2022-09-15T09:30:00+02:00;7;Tirol;9775862;4031028;5744834
2022-09-15T09:30:00+02:00;8;Vorarlberg;7177148;1597243;5579905
2022-09-15T09:30:00+02:00;9;Wien;69376038;61732975;7643063
2022-09-15T09:30:00+02:00;10;Österreich;196596718;101454697;95142021
2022-09-16T09:30:00+02:00;1;Burgenland;5577328;1984829;3592499
2022-09-16T09:30:00+02:00;2;Kärnten;6770032;1616962;5153070
2022-09-16T09:30:00+02:00;3;Niederösterreich;40288725;14664465;25624260
2022-09-16T09:30:00+02:00;4;Oberösterreich;25093204;6474283;18618921
2022-09-16T09:30:00+02:00;5;Salzburg;10858295;3174742;7683553
2022-09-16T09:30:00+02:00;6;Steiermark;21710621;6193939;15516682
2022-09-16T09:30:00+02:00;7;Tirol;9777580;4032746;5744834
2022-09-16T09:30:00+02:00;8;Vorarlberg;7178115;1597701;5580414
2022-09-16T09:30:00+02:00;9;Wien;69417086;61773775;7643311
2022-09-16T09:30:00+02:00;10;Österreich;196670986;101513442;95157544
2022-09-17T09:30:00+02:00;1;Burgenland;5580110;1987455;3592655
2022-09-17T09:30:00+02:00;2;Kärnten;6770599;1617520;5153079
2022-09-17T09:30:00+02:00;3;Niederösterreich;40293926;14668667;25625259
2022-09-17T09:30:00+02:00;4;Oberösterreich;25097946;6476897;18621049
2022-09-17T09:30:00+02:00;5;Salzburg;10859468;3175592;7683876
2022-09-17T09:30:00+02:00;6;Steiermark;21714761;6197394;15517367
2022-09-17T09:30:00+02:00;7;Tirol;9779409;4034575;5744834
2022-09-17T09:30:00+02:00;8;Vorarlberg;7178942;1598080;5580862
2022-09-17T09:30:00+02:00;9;Wien;69445917;61802325;7643592
2022-09-17T09:30:00+02:00;10;Österreich;196721078;101558505;95162573
2022-09-18T09:30:00+02:00;1;Burgenland;5582015;1989337;3592678
2022-09-18T09:30:00+02:00;2;Kärnten;6771209;1618130;5153079
2022-09-18T09:30:00+02:00;3;Niederösterreich;40297986;14672082;25625904
2022-09-18T09:30:00+02:00;4;Oberösterreich;25100941;6478601;18622340
2022-09-18T09:30:00+02:00;5;Salzburg;10860651;3176562;7684089
2022-09-18T09:30:00+02:00;6;Steiermark;21719810;6202179;15517631
2022-09-18T09:30:00+02:00;7;Tirol;9781059;4036225;5744834
2022-09-18T09:30:00+02:00;8;Vorarlberg;7179532;1598470;5581062
2022-09-18T09:30:00+02:00;9;Wien;69474016;61830214;7643802
2022-09-18T09:30:00+02:00;10;Österreich;196767219;101601800;95165419
2022-09-19T09:30:00+02:00;1;Burgenland;5583893;1991200;3592693
2022-09-19T09:30:00+02:00;2;Kärnten;6772028;1618948;5153080
2022-09-19T09:30:00+02:00;3;Niederösterreich;40301784;14674885;25626899
2022-09-19T09:30:00+02:00;4;Oberösterreich;25105140;6480698;18624442
2022-09-19T09:30:00+02:00;5;Salzburg;10861898;3177556;7684342
2022-09-19T09:30:00+02:00;6;Steiermark;21721655;6203986;15517669
2022-09-19T09:30:00+02:00;7;Tirol;9782277;4037443;5744834
2022-09-19T09:30:00+02:00;8;Vorarlberg;7180047;1598732;5581315
2022-09-19T09:30:00+02:00;9;Wien;69499103;61855028;7644075
2022-09-19T09:30:00+02:00;10;Österreich;196807825;101638476;95169349
2022-09-20T09:30:00+02:00;1;Burgenland;5588622;1993862;3594760
2022-09-20T09:30:00+02:00;2;Kärnten;6777447;1621157;5156290
2022-09-20T09:30:00+02:00;3;Niederösterreich;40309711;14679030;25630681
2022-09-20T09:30:00+02:00;4;Oberösterreich;25115509;6483602;18631907
2022-09-20T09:30:00+02:00;5;Salzburg;10863657;3178902;7684755
2022-09-20T09:30:00+02:00;6;Steiermark;21725814;6206904;15518910
2022-09-20T09:30:00+02:00;7;Tirol;9785516;4040682;5744834
2022-09-20T09:30:00+02:00;8;Vorarlberg;7181260;1599085;5582175
2022-09-20T09:30:00+02:00;9;Wien;69555506;61911132;7644374
2022-09-20T09:30:00+02:00;10;Österreich;196903042;101714356;95188686
2022-09-21T09:30:00+02:00;1;Burgenland;5591999;1997172;3594827
2022-09-21T09:30:00+02:00;2;Kärnten;6779201;1622631;5156570
2022-09-21T09:30:00+02:00;3;Niederösterreich;40314412;14682096;25632316
2022-09-21T09:30:00+02:00;4;Oberösterreich;25123016;6486660;18636356
2022-09-21T09:30:00+02:00;5;Salzburg;10865816;3180668;7685148
2022-09-21T09:30:00+02:00;6;Steiermark;21733617;6213821;15519796
2022-09-21T09:30:00+02:00;7;Tirol;9788123;4043289;5744834
2022-09-21T09:30:00+02:00;8;Vorarlberg;7182520;1599776;5582744
2022-09-21T09:30:00+02:00;9;Wien;69602443;61957751;7644692
2022-09-21T09:30:00+02:00;10;Österreich;196981147;101783864;95197283
2022-09-22T09:30:00+02:00;1;Burgenland;5596096;2000083;3596013
2022-09-22T09:30:00+02:00;2;Kärnten;6782496;1623972;5158524
2022-09-22T09:30:00+02:00;3;Niederösterreich;40321426;14687631;25633795
2022-09-22T09:30:00+02:00;4;Oberösterreich;25137249;6489316;18647933
2022-09-22T09:30:00+02:00;5;Salzburg;10867597;3182070;7685527
2022-09-22T09:30:00+02:00;6;Steiermark;21769457;6218908;15550549
2022-09-22T09:30:00+02:00;7;Tirol;9790730;4045896;5744834
2022-09-22T09:30:00+02:00;8;Vorarlberg;7183926;1600426;5583500
2022-09-22T09:30:00+02:00;9;Wien;69646823;62001860;7644963
2022-09-22T09:30:00+02:00;10;Österreich;197095800;101850162;95245638
2022-09-23T09:30:00+02:00;1;Burgenland;5598849;2002802;3596047
2022-09-23T09:30:00+02:00;2;Kärnten;6783790;1625266;5158524
2022-09-23T09:30:00+02:00;3;Niederösterreich;40325229;14690367;25634862
2022-09-23T09:30:00+02:00;4;Oberösterreich;25143144;6492459;18650685
2022-09-23T09:30:00+02:00;5;Salzburg;10869459;3183556;7685903
2022-09-23T09:30:00+02:00;6;Steiermark;21775843;6223884;15551959
2022-09-23T09:30:00+02:00;7;Tirol;9793207;4048373;5744834
2022-09-23T09:30:00+02:00;8;Vorarlberg;7185129;1601050;5584079
2022-09-23T09:30:00+02:00;9;Wien;69692111;62046887;7645224
2022-09-23T09:30:00+02:00;10;Österreich;197166761;101914644;95252117
2022-09-24T09:30:00+02:00;1;Burgenland;5602873;2005518;3597355
2022-09-24T09:30:00+02:00;2;Kärnten;6784505;1625974;5158531
2022-09-24T09:30:00+02:00;3;Niederösterreich;40330821;14694958;25635863
2022-09-24T09:30:00+02:00;4;Oberösterreich;25149940;6497160;18652780
2022-09-24T09:30:00+02:00;5;Salzburg;10871233;3184995;7686238
2022-09-24T09:30:00+02:00;6;Steiermark;21781753;6228652;15553101
2022-09-24T09:30:00+02:00;7;Tirol;9795635;4050801;5744834
2022-09-24T09:30:00+02:00;8;Vorarlberg;7186330;1601764;5584566
2022-09-24T09:30:00+02:00;9;Wien;69729666;62084129;7645537
2022-09-24T09:30:00+02:00;10;Österreich;197232756;101973951;95258805
2022-09-25T09:30:00+02:00;1;Burgenland;5605702;2008310;3597392
2022-09-25T09:30:00+02:00;2;Kärnten;6785353;1626822;5158531
2022-09-25T09:30:00+02:00;3;Niederösterreich;40335663;14699567;25636096
2022-09-25T09:30:00+02:00;4;Oberösterreich;25153607;6499706;18653901
2022-09-25T09:30:00+02:00;5;Salzburg;10872653;3186215;7686438
2022-09-25T09:30:00+02:00;6;Steiermark;21787165;6233621;15553544
2022-09-25T09:30:00+02:00;7;Tirol;9798067;4053233;5744834
2022-09-25T09:30:00+02:00;8;Vorarlberg;7187316;1602498;5584818
2022-09-25T09:30:00+02:00;9;Wien;69755967;62110171;7645796
2022-09-25T09:30:00+02:00;10;Österreich;197281493;102020143;95261350
2022-09-26T09:30:00+02:00;1;Burgenland;5607391;2009979;3597412
2022-09-26T09:30:00+02:00;2;Kärnten;6787141;1628215;5158926
2022-09-26T09:30:00+02:00;3;Niederösterreich;40339179;14702785;25636394
2022-09-26T09:30:00+02:00;4;Oberösterreich;25157956;6501962;18655994
2022-09-26T09:30:00+02:00;5;Salzburg;10874122;3187377;7686745
2022-09-26T09:30:00+02:00;6;Steiermark;21790419;6236317;15554102
2022-09-26T09:30:00+02:00;7;Tirol;9800155;4055321;5744834
2022-09-26T09:30:00+02:00;8;Vorarlberg;7188104;1603016;5585088
2022-09-26T09:30:00+02:00;9;Wien;69786143;62140049;7646094
2022-09-26T09:30:00+02:00;10;Österreich;197330610;102065021;95265589
2022-09-27T09:30:00+02:00;1;Burgenland;5610599;2013166;3597433
2022-09-27T09:30:00+02:00;2;Kärnten;6790624;1630601;5160023
2022-09-27T09:30:00+02:00;3;Niederösterreich;40344953;14707239;25637714
2022-09-27T09:30:00+02:00;4;Oberösterreich;25166442;6505569;18660873
2022-09-27T09:30:00+02:00;5;Salzburg;10883902;3189441;7694461
2022-09-27T09:30:00+02:00;6;Steiermark;21796258;6240037;15556221
2022-09-27T09:30:00+02:00;7;Tirol;9804947;4060113;5744834
2022-09-27T09:30:00+02:00;8;Vorarlberg;7189769;1603565;5586204
2022-09-27T09:30:00+02:00;9;Wien;69848262;62201804;7646458
2022-09-27T09:30:00+02:00;10;Österreich;197435756;102151535;95284221
2022-09-28T09:30:00+02:00;1;Burgenland;5614541;2017062;3597479
2022-09-28T09:30:00+02:00;2;Kärnten;6792678;1632170;5160508
2022-09-28T09:30:00+02:00;3;Niederösterreich;40353732;14712425;25641307
2022-09-28T09:30:00+02:00;4;Oberösterreich;25175867;6510092;18665775
2022-09-28T09:30:00+02:00;5;Salzburg;10886766;3191849;7694917
2022-09-28T09:30:00+02:00;6;Steiermark;21816573;6248672;15567901
2022-09-28T09:30:00+02:00;7;Tirol;9809009;4064175;5744834
2022-09-28T09:30:00+02:00;8;Vorarlberg;7191687;1604721;5586966
2022-09-28T09:30:00+02:00;9;Wien;69902908;62256152;7646756
2022-09-28T09:30:00+02:00;10;Österreich;197543761;102237318;95306443
2022-09-29T09:30:00+02:00;1;Burgenland;5617242;2019700;3597542
2022-09-29T09:30:00+02:00;2;Kärnten;6795098;1634375;5160723
2022-09-29T09:30:00+02:00;3;Niederösterreich;40360553;14717247;25643306
2022-09-29T09:30:00+02:00;4;Oberösterreich;25196137;6513476;18682661
2022-09-29T09:30:00+02:00;5;Salzburg;10889441;3194113;7695328
2022-09-29T09:30:00+02:00;6;Steiermark;21824326;6254868;15569458
2022-09-29T09:30:00+02:00;7;Tirol;9812991;4068157;5744834
2022-09-29T09:30:00+02:00;8;Vorarlberg;7193385;1605688;5587697
2022-09-29T09:30:00+02:00;9;Wien;69953392;62306319;7647073
2022-09-29T09:30:00+02:00;10;Österreich;197642565;102313943;95328622
2022-09-30T09:30:00+02:00;1;Burgenland;5619894;2022304;3597590
2022-09-30T09:30:00+02:00;2;Kärnten;6797393;1636076;5161317
2022-09-30T09:30:00+02:00;3;Niederösterreich;40365728;14720988;25644740
2022-09-30T09:30:00+02:00;4;Oberösterreich;25204290;6518592;18685698
2022-09-30T09:30:00+02:00;5;Salzburg;10891623;3195881;7695742
2022-09-30T09:30:00+02:00;6;Steiermark;21848089;6260932;15587157
2022-09-30T09:30:00+02:00;7;Tirol;9816720;4071886;5744834
2022-09-30T09:30:00+02:00;8;Vorarlberg;7195124;1606673;5588451
2022-09-30T09:30:00+02:00;9;Wien;70007091;62359722;7647369
2022-09-30T09:30:00+02:00;10;Österreich;197745952;102393054;95352898
2022-10-01T09:30:00+02:00;1;Burgenland;5619894;2022304;3597590
2022-10-01T09:30:00+02:00;2;Kärnten;6797393;1636076;5161317
2022-10-01T09:30:00+02:00;3;Niederösterreich;40365728;14720988;25644740
2022-10-01T09:30:00+02:00;4;Oberösterreich;25204290;6518592;18685698
2022-10-01T09:30:00+02:00;5;Salzburg;10891623;3195881;7695742
2022-10-01T09:30:00+02:00;6;Steiermark;21848089;6260932;15587157
2022-10-01T09:30:00+02:00;7;Tirol;9816720;4071886;5744834
2022-10-01T09:30:00+02:00;8;Vorarlberg;7195124;1606673;5588451
2022-10-01T09:30:00+02:00;9;Wien;70007091;62359722;7647369
2022-10-01T09:30:00+02:00;10;Österreich;197745952;102393054;95352898
2022-10-02T09:30:00+02:00;1;Burgenland;5619894;2022304;3597590
2022-10-02T09:30:00+02:00;2;Kärnten;6797393;1636076;5161317
2022-10-02T09:30:00+02:00;3;Niederösterreich;40365728;14720988;25644740
2022-10-02T09:30:00+02:00;4;Oberösterreich;25204290;6518592;18685698
2022-10-02T09:30:00+02:00;5;Salzburg;10891623;3195881;7695742
2022-10-02T09:30:00+02:00;6;Steiermark;21848089;6260932;15587157
2022-10-02T09:30:00+02:00;7;Tirol;9816720;4071886;5744834
2022-10-02T09:30:00+02:00;8;Vorarlberg;7195124;1606673;5588451
2022-10-02T09:30:00+02:00;9;Wien;70007091;62359722;7647369
2022-10-02T09:30:00+02:00;10;Österreich;197745952;102393054;95352898
2022-10-03T09:30:00+02:00;1;Burgenland;5623848;2026202;3597646
2022-10-03T09:30:00+02:00;2;Kärnten;6802369;1639089;5163280
2022-10-03T09:30:00+02:00;3;Niederösterreich;40383049;14735414;25647635
2022-10-03T09:30:00+02:00;4;Oberösterreich;25221971;6530267;18691704
2022-10-03T09:30:00+02:00;5;Salzburg;10896616;3199975;7696641
2022-10-03T09:30:00+02:00;6;Steiermark;21850790;6277244;15573546
2022-10-03T09:30:00+02:00;7;Tirol;9826748;4081914;5744834
2022-10-03T09:30:00+02:00;8;Vorarlberg;7199083;1609349;5589734
2022-10-03T09:30:00+02:00;9;Wien;70113805;62465483;7648322
2022-10-03T09:30:00+02:00;10;Österreich;197918279;102564937;95353342
2022-10-04T09:30:00+02:00;1;Burgenland;5630278;2031582;3598696
2022-10-04T09:30:00+02:00;2;Kärnten;6806376;1641961;5164415
2022-10-04T09:30:00+02:00;3;Niederösterreich;40391175;14740914;25650261
2022-10-04T09:30:00+02:00;4;Oberösterreich;25236150;6535261;18700889
2022-10-04T09:30:00+02:00;5;Salzburg;10908374;3203474;7704900
2022-10-04T09:30:00+02:00;6;Steiermark;21857078;6281281;15575797
2022-10-04T09:30:00+02:00;7;Tirol;9833235;4088401;5744834
2022-10-04T09:30:00+02:00;8;Vorarlberg;7200913;1610096;5590817
2022-10-04T09:30:00+02:00;9;Wien;70183504;62534818;7648686
2022-10-04T09:30:00+02:00;10;Österreich;198047083;102667788;95379295
2022-10-05T09:30:00+02:00;1;Burgenland;5636865;2038121;3598744
2022-10-05T09:30:00+02:00;2;Kärnten;6809861;1643864;5165997
2022-10-05T09:30:00+02:00;3;Niederösterreich;40403671;14748593;25655078
2022-10-05T09:30:00+02:00;4;Oberösterreich;25245688;6540271;18705417
2022-10-05T09:30:00+02:00;5;Salzburg;10911700;3206382;7705318
2022-10-05T09:30:00+02:00;6;Steiermark;21882743;6292327;15590416
2022-10-05T09:30:00+02:00;7;Tirol;9838337;4093503;5744834
2022-10-05T09:30:00+02:00;8;Vorarlberg;7203436;1611654;5591782
2022-10-05T09:30:00+02:00;9;Wien;70239923;62590935;7648988
2022-10-05T09:30:00+02:00;10;Österreich;198172224;102765650;95406574
2022-10-06T09:30:00+02:00;1;Burgenland;5653121;2042122;3610999
2022-10-06T09:30:00+02:00;2;Kärnten;6812686;1645832;5166854
2022-10-06T09:30:00+02:00;3;Niederösterreich;40410766;14754175;25656591
2022-10-06T09:30:00+02:00;4;Oberösterreich;25262646;6544120;18718526
2022-10-06T09:30:00+02:00;5;Salzburg;10915236;3209496;7705740
2022-10-06T09:30:00+02:00;6;Steiermark;21891743;6299624;15592119
2022-10-06T09:30:00+02:00;7;Tirol;9843373;4098539;5744834
2022-10-06T09:30:00+02:00;8;Vorarlberg;7205431;1612827;5592604
2022-10-06T09:30:00+02:00;9;Wien;70295152;62645755;7649397
2022-10-06T09:30:00+02:00;10;Österreich;198290154;102852490;95437664
2022-10-07T09:30:00+02:00;1;Burgenland;5655934;2044880;3611054
2022-10-07T09:30:00+02:00;2;Kärnten;6815552;1647227;5168325
2022-10-07T09:30:00+02:00;3;Niederösterreich;40416872;14758790;25658082
2022-10-07T09:30:00+02:00;4;Oberösterreich;25270898;6549121;18721777
2022-10-07T09:30:00+02:00;5;Salzburg;10917530;3211416;7706114
2022-10-07T09:30:00+02:00;6;Steiermark;21900871;6307111;15593760
2022-10-07T09:30:00+02:00;7;Tirol;9847909;4103075;5744834
2022-10-07T09:30:00+02:00;8;Vorarlberg;7207418;1614014;5593404
2022-10-07T09:30:00+02:00;9;Wien;70356065;62706337;7649728
2022-10-07T09:30:00+02:00;10;Österreich;198389049;102941971;95447078
2022-10-08T09:30:00+02:00;1;Burgenland;5655934;2044880;3611054
2022-10-08T09:30:00+02:00;2;Kärnten;6815552;1647227;5168325
2022-10-08T09:30:00+02:00;3;Niederösterreich;40416872;14758790;25658082
2022-10-08T09:30:00+02:00;4;Oberösterreich;25270898;6549121;18721777
2022-10-08T09:30:00+02:00;5;Salzburg;10917530;3211416;7706114
2022-10-08T09:30:00+02:00;6;Steiermark;21900871;6307111;15593760
2022-10-08T09:30:00+02:00;7;Tirol;9847909;4103075;5744834
2022-10-08T09:30:00+02:00;8;Vorarlberg;7207418;1614014;5593404
2022-10-08T09:30:00+02:00;9;Wien;70356065;62706337;7649728
2022-10-08T09:30:00+02:00;10;Österreich;198389049;102941971;95447078
2022-10-09T09:30:00+02:00;1;Burgenland;5655934;2044880;3611054
2022-10-09T09:30:00+02:00;2;Kärnten;6815552;1647227;5168325
2022-10-09T09:30:00+02:00;3;Niederösterreich;40416872;14758790;25658082
2022-10-09T09:30:00+02:00;4;Oberösterreich;25270898;6549121;18721777
2022-10-09T09:30:00+02:00;5;Salzburg;10917530;3211416;7706114
2022-10-09T09:30:00+02:00;6;Steiermark;21900871;6307111;15593760
2022-10-09T09:30:00+02:00;7;Tirol;9847909;4103075;5744834
2022-10-09T09:30:00+02:00;8;Vorarlberg;7207418;1614014;5593404
2022-10-09T09:30:00+02:00;9;Wien;70356065;62706337;7649728
2022-10-09T09:30:00+02:00;10;Österreich;198389049;102941971;95447078
2022-10-10T09:30:00+02:00;1;Burgenland;5661230;2049529;3611701
2022-10-10T09:30:00+02:00;2;Kärnten;6819487;1651109;5168378
2022-10-10T09:30:00+02:00;3;Niederösterreich;40435199;14775222;25659977
2022-10-10T09:30:00+02:00;4;Oberösterreich;25288424;6560766;18727658
2022-10-10T09:30:00+02:00;5;Salzburg;10924523;3217510;7707013
2022-10-10T09:30:00+02:00;6;Steiermark;21921888;6325565;15596323
2022-10-10T09:30:00+02:00;7;Tirol;9859292;4114458;5744834
2022-10-10T09:30:00+02:00;8;Vorarlberg;7211545;1616878;5594667
2022-10-10T09:30:00+02:00;9;Wien;70475175;62824451;7650724
2022-10-10T09:30:00+02:00;10;Österreich;198596763;103135488;95461275
2022-10-11T09:30:00+02:00;1;Burgenland;5668784;2057061;3611723
2022-10-11T09:30:00+02:00;2;Kärnten;6825551;1654450;5171101
2022-10-11T09:30:00+02:00;3;Niederösterreich;40443415;14781391;25662024
2022-10-11T09:30:00+02:00;4;Oberösterreich;25320690;6565653;18755037
2022-10-11T09:30:00+02:00;5;Salzburg;10935962;3220354;7715608
2022-10-11T09:30:00+02:00;6;Steiermark;21928921;6330301;15598620
2022-10-11T09:30:00+02:00;7;Tirol;9863377;4118543;5744834
2022-10-11T09:30:00+02:00;8;Vorarlberg;7213522;1617716;5595806
2022-10-11T09:30:00+02:00;9;Wien;70541964;62890824;7651140
2022-10-11T09:30:00+02:00;10;Österreich;198742186;103236293;95505893
2022-10-12T09:30:00+02:00;1;Burgenland;5673501;2061735;3611766
2022-10-12T09:30:00+02:00;2;Kärnten;6829781;1656476;5173305
2022-10-12T09:30:00+02:00;3;Niederösterreich;40452426;14788399;25664027
2022-10-12T09:30:00+02:00;4;Oberösterreich;25330999;6570130;18760869
2022-10-12T09:30:00+02:00;5;Salzburg;10939513;3223427;7716086
2022-10-12T09:30:00+02:00;6;Steiermark;21955639;6342195;15613444
2022-10-12T09:30:00+02:00;7;Tirol;9872696;4127862;5744834
2022-10-12T09:30:00+02:00;8;Vorarlberg;7216054;1619350;5596704
2022-10-12T09:30:00+02:00;9;Wien;70604066;62952566;7651500
2022-10-12T09:30:00+02:00;10;Österreich;198874675;103342140;95532535
2022-10-13T09:30:00+02:00;1;Burgenland;5678142;2066343;3611799
2022-10-13T09:30:00+02:00;2;Kärnten;6832747;1658743;5174004
2022-10-13T09:30:00+02:00;3;Niederösterreich;40461403;14795502;25665901
2022-10-13T09:30:00+02:00;4;Oberösterreich;25338057;6573669;18764388
2022-10-13T09:30:00+02:00;5;Salzburg;10942463;3225931;7716532
2022-10-13T09:30:00+02:00;6;Steiermark;21965287;6350173;15615114
2022-10-13T09:30:00+02:00;7;Tirol;9875518;4130684;5744834
2022-10-13T09:30:00+02:00;8;Vorarlberg;7218056;1620551;5597505
2022-10-13T09:30:00+02:00;9;Wien;70660485;63008592;7651893
2022-10-13T09:30:00+02:00;10;Österreich;198972158;103430188;95541970
2022-10-14T09:30:00+02:00;1;Burgenland;5682935;2070065;3612870
2022-10-14T09:30:00+02:00;2;Kärnten;6834285;1660281;5174004
2022-10-14T09:30:00+02:00;3;Niederösterreich;40469007;14801235;25667772
2022-10-14T09:30:00+02:00;4;Oberösterreich;25361541;6578847;18782694
2022-10-14T09:30:00+02:00;5;Salzburg;10945142;3228198;7716944
2022-10-14T09:30:00+02:00;6;Steiermark;21974832;6358077;15616755
2022-10-14T09:30:00+02:00;7;Tirol;9768953;4024119;5744834
2022-10-14T09:30:00+02:00;8;Vorarlberg;7219814;1621629;5598185
2022-10-14T09:30:00+02:00;9;Wien;70713087;63060855;7652232
2022-10-14T09:30:00+02:00;10;Österreich;198969596;103403306;95566290
2022-10-15T09:30:00+02:00;1;Burgenland;5682935;2070065;3612870
2022-10-15T09:30:00+02:00;2;Kärnten;6834285;1660281;5174004
2022-10-15T09:30:00+02:00;3;Niederösterreich;40469007;14801235;25667772
2022-10-15T09:30:00+02:00;4;Oberösterreich;25361541;6578847;18782694
2022-10-15T09:30:00+02:00;5;Salzburg;10945142;3228198;7716944
2022-10-15T09:30:00+02:00;6;Steiermark;21974832;6358077;15616755
2022-10-15T09:30:00+02:00;7;Tirol;9768953;4024119;5744834
2022-10-15T09:30:00+02:00;8;Vorarlberg;7219814;1621629;5598185
2022-10-15T09:30:00+02:00;9;Wien;70713087;63060855;7652232
2022-10-15T09:30:00+02:00;10;Österreich;198969596;103403306;95566290
2022-10-16T09:30:00+02:00;1;Burgenland;5682935;2070065;3612870
2022-10-16T09:30:00+02:00;2;Kärnten;6834285;1660281;5174004
2022-10-16T09:30:00+02:00;3;Niederösterreich;40469007;14801235;25667772
2022-10-16T09:30:00+02:00;4;Oberösterreich;25361541;6578847;18782694
2022-10-16T09:30:00+02:00;5;Salzburg;10945142;3228198;7716944
2022-10-16T09:30:00+02:00;6;Steiermark;21974832;6358077;15616755
2022-10-16T09:30:00+02:00;7;Tirol;9768953;4024119;5744834
2022-10-16T09:30:00+02:00;8;Vorarlberg;7219814;1621629;5598185
2022-10-16T09:30:00+02:00;9;Wien;70713087;63060855;7652232
2022-10-16T09:30:00+02:00;10;Österreich;198969596;103403306;95566290
2022-10-17T09:30:00+02:00;1;Burgenland;5689295;2076176;3613119
2022-10-17T09:30:00+02:00;2;Kärnten;6837667;1663451;5174216
2022-10-17T09:30:00+02:00;3;Niederösterreich;40492348;14818572;25673776
2022-10-17T09:30:00+02:00;4;Oberösterreich;25378307;6589673;18788634
2022-10-17T09:30:00+02:00;5;Salzburg;10950886;3233040;7717846
2022-10-17T09:30:00+02:00;6;Steiermark;21996701;6377380;15619321
2022-10-17T09:30:00+02:00;7;Tirol;9777931;4033097;5744834
2022-10-17T09:30:00+02:00;8;Vorarlberg;7223759;1624178;5599581
2022-10-17T09:30:00+02:00;9;Wien;70838601;63185378;7653223
2022-10-17T09:30:00+02:00;10;Österreich;199185495;103600945;95584550
2022-10-18T09:30:00+02:00;1;Burgenland;5695221;2082077;3613144
2022-10-18T09:30:00+02:00;2;Kärnten;6841145;1666078;5175067
2022-10-18T09:30:00+02:00;3;Niederösterreich;40502447;14825331;25677116
2022-10-18T09:30:00+02:00;4;Oberösterreich;25385082;6593791;18791291
2022-10-18T09:30:00+02:00;5;Salzburg;10970370;3235746;7734624
2022-10-18T09:30:00+02:00;6;Steiermark;22003551;6381975;15621576
2022-10-18T09:30:00+02:00;7;Tirol;9782814;4037980;5744834
2022-10-18T09:30:00+02:00;8;Vorarlberg;7225715;1624812;5600903
2022-10-18T09:30:00+02:00;9;Wien;70902185;63248608;7653577
2022-10-18T09:30:00+02:00;10;Österreich;199308530;103696398;95612132
2022-10-19T09:30:00+02:00;1;Burgenland;5702077;2087155;3614922
2022-10-19T09:30:00+02:00;2;Kärnten;6845396;1667416;5177980
2022-10-19T09:30:00+02:00;3;Niederösterreich;40512762;14832217;25680545
2022-10-19T09:30:00+02:00;4;Oberösterreich;25395498;6597557;18797941
2022-10-19T09:30:00+02:00;5;Salzburg;10972938;3237891;7735047
2022-10-19T09:30:00+02:00;6;Steiermark;22037844;6392804;15645040
2022-10-19T09:30:00+02:00;7;Tirol;9786865;4042031;5744834
2022-10-19T09:30:00+02:00;8;Vorarlberg;7228157;1626116;5602041
2022-10-19T09:30:00+02:00;9;Wien;70953923;63300038;7653885
2022-10-19T09:30:00+02:00;10;Österreich;199435460;103783225;95652235
2022-10-20T09:30:00+02:00;1;Burgenland;5705873;2090909;3614964
2022-10-20T09:30:00+02:00;2;Kärnten;6846963;1668918;5178045
2022-10-20T09:30:00+02:00;3;Niederösterreich;40521028;14838313;25682715
2022-10-20T09:30:00+02:00;4;Oberösterreich;25417085;6600604;18816481
2022-10-20T09:30:00+02:00;5;Salzburg;10975499;3240039;7735460
2022-10-20T09:30:00+02:00;6;Steiermark;22046688;6400064;15646624
2022-10-20T09:30:00+02:00;7;Tirol;9790130;4045296;5744834
2022-10-20T09:30:00+02:00;8;Vorarlberg;7230092;1626960;5603132
2022-10-20T09:30:00+02:00;9;Wien;71006926;63352702;7654224
2022-10-20T09:30:00+02:00;10;Österreich;199540284;103863805;95676479
2022-10-21T09:30:00+02:00;1;Burgenland;5709088;2094082;3615006
2022-10-21T09:30:00+02:00;2;Kärnten;6848465;1670420;5178045
2022-10-21T09:30:00+02:00;3;Niederösterreich;40530881;14843385;25687496
2022-10-21T09:30:00+02:00;4;Oberösterreich;25424561;6604677;18819884
2022-10-21T09:30:00+02:00;5;Salzburg;10977332;3241482;7735850
2022-10-21T09:30:00+02:00;6;Steiermark;22054897;6406780;15648117
2022-10-21T09:30:00+02:00;7;Tirol;9792826;4047992;5744834
2022-10-21T09:30:00+02:00;8;Vorarlberg;7231843;1627847;5603996
2022-10-21T09:30:00+02:00;9;Wien;71055481;63400953;7654528
2022-10-21T09:30:00+02:00;10;Österreich;199625374;103937618;95687756
2022-10-22T09:30:00+02:00;1;Burgenland;5709088;2094082;3615006
2022-10-22T09:30:00+02:00;2;Kärnten;6848465;1670420;5178045
2022-10-22T09:30:00+02:00;3;Niederösterreich;40530881;14843385;25687496
2022-10-22T09:30:00+02:00;4;Oberösterreich;25424561;6604677;18819884
2022-10-22T09:30:00+02:00;5;Salzburg;10977332;3241482;7735850
2022-10-22T09:30:00+02:00;6;Steiermark;22054897;6406780;15648117
2022-10-22T09:30:00+02:00;7;Tirol;9792826;4047992;5744834
2022-10-22T09:30:00+02:00;8;Vorarlberg;7231843;1627847;5603996
2022-10-22T09:30:00+02:00;9;Wien;71055481;63400953;7654528
2022-10-22T09:30:00+02:00;10;Österreich;199625374;103937618;95687756
2022-10-23T09:30:00+02:00;1;Burgenland;5709088;2094082;3615006
2022-10-23T09:30:00+02:00;2;Kärnten;6848465;1670420;5178045
2022-10-23T09:30:00+02:00;3;Niederösterreich;40530881;14843385;25687496
2022-10-23T09:30:00+02:00;4;Oberösterreich;25424561;6604677;18819884
2022-10-23T09:30:00+02:00;5;Salzburg;10977332;3241482;7735850
2022-10-23T09:30:00+02:00;6;Steiermark;22054897;6406780;15648117
2022-10-23T09:30:00+02:00;7;Tirol;9792826;4047992;5744834
2022-10-23T09:30:00+02:00;8;Vorarlberg;7231843;1627847;5603996
2022-10-23T09:30:00+02:00;9;Wien;71055481;63400953;7654528
2022-10-23T09:30:00+02:00;10;Österreich;199625374;103937618;95687756
2022-10-24T09:30:00+02:00;1;Burgenland;5718394;2102756;3615638
2022-10-24T09:30:00+02:00;2;Kärnten;6851377;1673070;5178307
2022-10-24T09:30:00+02:00;3;Niederösterreich;40548332;14858190;25690142
2022-10-24T09:30:00+02:00;4;Oberösterreich;25438220;6612551;18825669
2022-10-24T09:30:00+02:00;5;Salzburg;10982030;3245314;7736716
2022-10-24T09:30:00+02:00;6;Steiermark;22072748;6422280;15650468
2022-10-24T09:30:00+02:00;7;Tirol;9799038;4054204;5744834
2022-10-24T09:30:00+02:00;8;Vorarlberg;7235038;1629792;5605246
2022-10-24T09:30:00+02:00;9;Wien;71153116;63497826;7655290
2022-10-24T09:30:00+02:00;10;Österreich;199798293;104095983;95702310
2022-10-25T09:30:00+02:00;1;Burgenland;5720693;2103155;3617538
2022-10-25T09:30:00+02:00;2;Kärnten;6856495;1674936;5181559
2022-10-25T09:30:00+02:00;3;Niederösterreich;40556504;14863653;25692851
2022-10-25T09:30:00+02:00;4;Oberösterreich;25446058;6615527;18830531
2022-10-25T09:30:00+02:00;5;Salzburg;10992171;3247311;7744860
2022-10-25T09:30:00+02:00;6;Steiermark;22078151;6425597;15652554
2022-10-25T09:30:00+02:00;7;Tirol;9803711;4058877;5744834
2022-10-25T09:30:00+02:00;8;Vorarlberg;7236550;1630232;5606318
2022-10-25T09:30:00+02:00;9;Wien;71207950;63552322;7655628
2022-10-25T09:30:00+02:00;10;Österreich;199898283;104171610;95726673
2022-10-26T09:30:00+02:00;1;Burgenland;5720693;2103155;3617538
2022-10-26T09:30:00+02:00;2;Kärnten;6856495;1674936;5181559
2022-10-26T09:30:00+02:00;3;Niederösterreich;40556504;14863653;25692851
2022-10-26T09:30:00+02:00;4;Oberösterreich;25446058;6615527;18830531
2022-10-26T09:30:00+02:00;5;Salzburg;10992171;3247311;7744860
2022-10-26T09:30:00+02:00;6;Steiermark;22078151;6425597;15652554
2022-10-26T09:30:00+02:00;7;Tirol;9803711;4058877;5744834
2022-10-26T09:30:00+02:00;8;Vorarlberg;7236550;1630232;5606318
2022-10-26T09:30:00+02:00;9;Wien;71207950;63552322;7655628
2022-10-26T09:30:00+02:00;10;Österreich;199898283;104171610;95726673
2022-10-27T09:30:00+02:00;1;Burgenland;5724407;2105882;3618525
2022-10-27T09:30:00+02:00;2;Kärnten;6859956;1676956;5183000
2022-10-27T09:30:00+02:00;3;Niederösterreich;40573635;14874868;25698767
2022-10-27T09:30:00+02:00;4;Oberösterreich;25469243;6619870;18849373
2022-10-27T09:30:00+02:00;5;Salzburg;10995012;3249588;7745424
2022-10-27T09:30:00+02:00;6;Steiermark;22107619;6438567;15669052
2022-10-27T09:30:00+02:00;7;Tirol;9810473;4065639;5744834
2022-10-27T09:30:00+02:00;8;Vorarlberg;7238959;1631657;5607302
2022-10-27T09:30:00+02:00;9;Wien;71288765;63632640;7656125
2022-10-27T09:30:00+02:00;10;Österreich;200068069;104295667;95772402
2022-10-28T09:30:00+02:00;1;Burgenland;5728269;2109709;3618560
2022-10-28T09:30:00+02:00;2;Kärnten;6861809;1678330;5183479
2022-10-28T09:30:00+02:00;3;Niederösterreich;40578127;14877854;25700273
2022-10-28T09:30:00+02:00;4;Oberösterreich;25473165;6623297;18849868
2022-10-28T09:30:00+02:00;5;Salzburg;10996810;3251027;7745783
2022-10-28T09:30:00+02:00;6;Steiermark;22111644;6440946;15670698
2022-10-28T09:30:00+02:00;7;Tirol;9813770;4068936;5744834
2022-10-28T09:30:00+02:00;8;Vorarlberg;7239821;1631921;5607900
2022-10-28T09:30:00+02:00;9;Wien;71324443;63668024;7656419
2022-10-28T09:30:00+02:00;10;Österreich;200127858;104350044;95777814
2022-10-29T09:30:00+02:00;1;Burgenland;5728269;2109709;3618560
2022-10-29T09:30:00+02:00;2;Kärnten;6861809;1678330;5183479
2022-10-29T09:30:00+02:00;3;Niederösterreich;40578127;14877854;25700273
2022-10-29T09:30:00+02:00;4;Oberösterreich;25473165;6623297;18849868
2022-10-29T09:30:00+02:00;5;Salzburg;10996810;3251027;7745783
2022-10-29T09:30:00+02:00;6;Steiermark;22111644;6440946;15670698
2022-10-29T09:30:00+02:00;7;Tirol;9813770;4068936;5744834
2022-10-29T09:30:00+02:00;8;Vorarlberg;7239821;1631921;5607900
2022-10-29T09:30:00+02:00;9;Wien;71324443;63668024;7656419
2022-10-29T09:30:00+02:00;10;Österreich;200127858;104350044;95777814
2022-10-30T09:30:00+02:00;1;Burgenland;5728269;2109709;3618560
2022-10-30T09:30:00+02:00;2;Kärnten;6861809;1678330;5183479
2022-10-30T09:30:00+02:00;3;Niederösterreich;40578127;14877854;25700273
2022-10-30T09:30:00+02:00;4;Oberösterreich;25473165;6623297;18849868
2022-10-30T09:30:00+02:00;5;Salzburg;10996810;3251027;7745783
2022-10-30T09:30:00+02:00;6;Steiermark;22111644;6440946;15670698
2022-10-30T09:30:00+02:00;7;Tirol;9813770;4068936;5744834
2022-10-30T09:30:00+02:00;8;Vorarlberg;7239821;1631921;5607900
2022-10-30T09:30:00+02:00;9;Wien;71324443;63668024;7656419
2022-10-30T09:30:00+02:00;10;Österreich;200127858;104350044;95777814
2022-10-31T09:30:00+02:00;1;Burgenland;5732180;2112329;3619851
2022-10-31T09:30:00+02:00;2;Kärnten;6864712;1680348;5184364
2022-10-31T09:30:00+02:00;3;Niederösterreich;40593221;14891035;25702186
2022-10-31T09:30:00+02:00;4;Oberösterreich;25483847;6628922;18854925
2022-10-31T09:30:00+02:00;5;Salzburg;11005590;3253732;7751858
2022-10-31T09:30:00+02:00;6;Steiermark;22126227;6453491;15672736
2022-10-31T09:30:00+02:00;7;Tirol;9819068;4074234;5744834
2022-10-31T09:30:00+02:00;8;Vorarlberg;7242331;1633323;5609008
2022-10-31T09:30:00+02:00;9;Wien;71388825;63731974;7656851
2022-10-31T09:30:00+02:00;10;Österreich;200256001;104459388;95796613
2022-11-01T09:30:00+02:00;1;Burgenland;5732180;2112329;3619851
2022-11-01T09:30:00+02:00;2;Kärnten;6864712;1680348;5184364
2022-11-01T09:30:00+02:00;3;Niederösterreich;40593221;14891035;25702186
2022-11-01T09:30:00+02:00;4;Oberösterreich;25483847;6628922;18854925
2022-11-01T09:30:00+02:00;5;Salzburg;11005590;3253732;7751858
2022-11-01T09:30:00+02:00;6;Steiermark;22126227;6453491;15672736
2022-11-01T09:30:00+02:00;7;Tirol;9819068;4074234;5744834
2022-11-01T09:30:00+02:00;8;Vorarlberg;7242331;1633323;5609008
2022-11-01T09:30:00+02:00;9;Wien;71388825;63731974;7656851
2022-11-01T09:30:00+02:00;10;Österreich;200256001;104459388;95796613
2022-11-02T09:30:00+02:00;1;Burgenland;5732241;2112329;3619912
2022-11-02T09:30:00+02:00;2;Kärnten;6867257;1682063;5185194
2022-11-02T09:30:00+02:00;3;Niederösterreich;40609699;14901150;25708549
2022-11-02T09:30:00+02:00;4;Oberösterreich;25493549;6632571;18860978
2022-11-02T09:30:00+02:00;5;Salzburg;11008413;3256013;7752400
2022-11-02T09:30:00+02:00;6;Steiermark;22147515;6462351;15685164
2022-11-02T09:30:00+02:00;7;Tirol;9823902;4079068;5744834
2022-11-02T09:30:00+02:00;8;Vorarlberg;7244203;1634166;5610037
2022-11-02T09:30:00+02:00;9;Wien;71477253;63819583;7657670
2022-11-02T09:30:00+02:00;10;Österreich;200404032;104579294;95824738
2022-11-03T09:30:00+02:00;1;Burgenland;5743067;2122225;3620842
2022-11-03T09:30:00+02:00;2;Kärnten;6871869;1684314;5187555
2022-11-03T09:30:00+02:00;3;Niederösterreich;40615603;14904438;25711165
2022-11-03T09:30:00+02:00;4;Oberösterreich;25509970;6634198;18875772
2022-11-03T09:30:00+02:00;5;Salzburg;11010351;3257538;7752813
2022-11-03T09:30:00+02:00;6;Steiermark;22152464;6465191;15687273
2022-11-03T09:30:00+02:00;7;Tirol;9827559;4082725;5744834
2022-11-03T09:30:00+02:00;8;Vorarlberg;7245469;1634436;5611033
2022-11-03T09:30:00+02:00;9;Wien;71528206;63870273;7657933
2022-11-03T09:30:00+02:00;10;Österreich;200504558;104655338;95849220
2022-11-04T09:30:00+02:00;1;Burgenland;5745674;2124814;3620860
2022-11-04T09:30:00+02:00;2;Kärnten;6874144;1685264;5188880
2022-11-04T09:30:00+02:00;3;Niederösterreich;40621040;14907873;25713167
2022-11-04T09:30:00+02:00;4;Oberösterreich;25515997;6637147;18878850
2022-11-04T09:30:00+02:00;5;Salzburg;11011785;3258590;7753195
2022-11-04T09:30:00+02:00;6;Steiermark;22159789;6470860;15688929
2022-11-04T09:30:00+02:00;7;Tirol;9829754;4084920;5744834
2022-11-04T09:30:00+02:00;8;Vorarlberg;7246717;1634981;5611736
2022-11-04T09:30:00+02:00;9;Wien;71573083;63914924;7658159
2022-11-04T09:30:00+02:00;10;Österreich;200577983;104719373;95858610
2022-11-05T09:30:00+02:00;1;Burgenland;5745674;2124814;3620860
2022-11-05T09:30:00+02:00;2;Kärnten;6874144;1685264;5188880
2022-11-05T09:30:00+02:00;3;Niederösterreich;40621040;14907873;25713167
2022-11-05T09:30:00+02:00;4;Oberösterreich;25515997;6637147;18878850
2022-11-05T09:30:00+02:00;5;Salzburg;11011785;3258590;7753195
2022-11-05T09:30:00+02:00;6;Steiermark;22159789;6470860;15688929
2022-11-05T09:30:00+02:00;7;Tirol;9829754;4084920;5744834
2022-11-05T09:30:00+02:00;8;Vorarlberg;7246717;1634981;5611736
2022-11-05T09:30:00+02:00;9;Wien;71573083;63914924;7658159
2022-11-05T09:30:00+02:00;10;Österreich;200577983;104719373;95858610
2022-11-06T09:30:00+02:00;1;Burgenland;5745674;2124814;3620860
2022-11-06T09:30:00+02:00;2;Kärnten;6874144;1685264;5188880
2022-11-06T09:30:00+02:00;3;Niederösterreich;40621040;14907873;25713167
2022-11-06T09:30:00+02:00;4;Oberösterreich;25515997;6637147;18878850
2022-11-06T09:30:00+02:00;5;Salzburg;11011785;3258590;7753195
2022-11-06T09:30:00+02:00;6;Steiermark;22159789;6470860;15688929
2022-11-06T09:30:00+02:00;7;Tirol;9829754;4084920;5744834
2022-11-06T09:30:00+02:00;8;Vorarlberg;7246717;1634981;5611736
2022-11-06T09:30:00+02:00;9;Wien;71573083;63914924;7658159
2022-11-06T09:30:00+02:00;10;Österreich;200577983;104719373;95858610
2022-11-07T09:30:00+02:00;1;Burgenland;5751741;2128990;3622751
2022-11-07T09:30:00+02:00;2;Kärnten;6876822;1687456;5189366
2022-11-07T09:30:00+02:00;3;Niederösterreich;40636909;14921183;25715726
2022-11-07T09:30:00+02:00;4;Oberösterreich;25527643;6642742;18884901
2022-11-07T09:30:00+02:00;5;Salzburg;11014214;3260313;7753901
2022-11-07T09:30:00+02:00;6;Steiermark;22173235;6481951;15691284
2022-11-07T09:30:00+02:00;7;Tirol;9834756;4089922;5744834
2022-11-07T09:30:00+02:00;8;Vorarlberg;7248886;1636034;5612852
2022-11-07T09:30:00+02:00;9;Wien;71656558;63997794;7658764
2022-11-07T09:30:00+02:00;10;Österreich;200720764;104846385;95874379
2022-11-08T09:30:00+02:00;1;Burgenland;5759330;2136579;3622751
2022-11-08T09:30:00+02:00;2;Kärnten;6880155;1689470;5190685
2022-11-08T09:30:00+02:00;3;Niederösterreich;40643998;14925473;25718525
2022-11-08T09:30:00+02:00;4;Oberösterreich;25533899;6645010;18888889
2022-11-08T09:30:00+02:00;5;Salzburg;11023419;3262634;7760785
2022-11-08T09:30:00+02:00;6;Steiermark;22177936;6484561;15693375
2022-11-08T09:30:00+02:00;7;Tirol;9838299;4093465;5744834
2022-11-08T09:30:00+02:00;8;Vorarlberg;7249947;1636273;5613674
2022-11-08T09:30:00+02:00;9;Wien;71709195;64050173;7659022
2022-11-08T09:30:00+02:00;10;Österreich;200816178;104923638;95892540
2022-11-09T09:30:00+02:00;1;Burgenland;5763985;2140126;3623859
2022-11-09T09:30:00+02:00;2;Kärnten;6881828;1690390;5191438
2022-11-09T09:30:00+02:00;3;Niederösterreich;40655681;14930613;25725068
2022-11-09T09:30:00+02:00;4;Oberösterreich;25540399;6647017;18893382
2022-11-09T09:30:00+02:00;5;Salzburg;11025090;3263939;7761151
2022-11-09T09:30:00+02:00;6;Steiermark;22201171;6491273;15709898
2022-11-09T09:30:00+02:00;7;Tirol;9839351;4094517;5744834
2022-11-09T09:30:00+02:00;8;Vorarlberg;7251261;1636858;5614403
2022-11-09T09:30:00+02:00;9;Wien;71752241;64092975;7659266
2022-11-09T09:30:00+02:00;10;Österreich;200911007;104987708;95923299
2022-11-10T09:30:00+02:00;1;Burgenland;5766760;2142886;3623874
2022-11-10T09:30:00+02:00;2;Kärnten;6884126;1691524;5192602
2022-11-10T09:30:00+02:00;3;Niederösterreich;40662720;14934919;25727801
2022-11-10T09:30:00+02:00;4;Oberösterreich;25545355;6648758;18896597
2022-11-10T09:30:00+02:00;5;Salzburg;11026519;3265024;7761495
2022-11-10T09:30:00+02:00;6;Steiermark;22220132;6495727;15724405
2022-11-10T09:30:00+02:00;7;Tirol;10391945;4647111;5744834
2022-11-10T09:30:00+02:00;8;Vorarlberg;7252427;1637241;5615186
2022-11-10T09:30:00+02:00;9;Wien;71793049;64133587;7659462
2022-11-10T09:30:00+02:00;10;Österreich;201543033;105596777;95946256
2022-11-11T09:30:00+02:00;1;Burgenland;5769760;2145871;3623889
2022-11-11T09:30:00+02:00;2;Kärnten;6884846;1692244;5192602
2022-11-11T09:30:00+02:00;3;Niederösterreich;40669665;14939247;25730418
2022-11-11T09:30:00+02:00;4;Oberösterreich;25551110;6651501;18899609
2022-11-11T09:30:00+02:00;5;Salzburg;11027944;3266120;7761824
2022-11-11T09:30:00+02:00;6;Steiermark;22226141;6500201;15725940
2022-11-11T09:30:00+02:00;7;Tirol;10393956;4649122;5744834
2022-11-11T09:30:00+02:00;8;Vorarlberg;7253426;1637612;5615814
2022-11-11T09:30:00+02:00;9;Wien;71831271;64171508;7659763
2022-11-11T09:30:00+02:00;10;Österreich;201608119;105653426;95954693
2022-11-12T09:30:00+02:00;1;Burgenland;5769760;2145871;3623889
2022-11-12T09:30:00+02:00;2;Kärnten;6884846;1692244;5192602
2022-11-12T09:30:00+02:00;3;Niederösterreich;40669665;14939247;25730418
2022-11-12T09:30:00+02:00;4;Oberösterreich;25551110;6651501;18899609
2022-11-12T09:30:00+02:00;5;Salzburg;11027944;3266120;7761824
2022-11-12T09:30:00+02:00;6;Steiermark;22226141;6500201;15725940
2022-11-12T09:30:00+02:00;7;Tirol;10393956;4649122;5744834
2022-11-12T09:30:00+02:00;8;Vorarlberg;7253426;1637612;5615814
2022-11-12T09:30:00+02:00;9;Wien;71831271;64171508;7659763
2022-11-12T09:30:00+02:00;10;Österreich;201608119;105653426;95954693
2022-11-13T09:30:00+02:00;1;Burgenland;5769760;2145871;3623889
2022-11-13T09:30:00+02:00;2;Kärnten;6884846;1692244;5192602
2022-11-13T09:30:00+02:00;3;Niederösterreich;40669665;14939247;25730418
2022-11-13T09:30:00+02:00;4;Oberösterreich;25551110;6651501;18899609
2022-11-13T09:30:00+02:00;5;Salzburg;11027944;3266120;7761824
2022-11-13T09:30:00+02:00;6;Steiermark;22226141;6500201;15725940
2022-11-13T09:30:00+02:00;7;Tirol;10393956;4649122;5744834
2022-11-13T09:30:00+02:00;8;Vorarlberg;7253426;1637612;5615814
2022-11-13T09:30:00+02:00;9;Wien;71831271;64171508;7659763
2022-11-13T09:30:00+02:00;10;Österreich;201608119;105653426;95954693
2022-11-14T09:30:00+02:00;1;Burgenland;5777270;2151926;3625344
2022-11-14T09:30:00+02:00;2;Kärnten;6886511;1693887;5192624
2022-11-14T09:30:00+02:00;3;Niederösterreich;40684536;14950830;25733706
2022-11-14T09:30:00+02:00;4;Oberösterreich;25561603;6656117;18905486
2022-11-14T09:30:00+02:00;5;Salzburg;11030946;3268410;7762536
2022-11-14T09:30:00+02:00;6;Steiermark;22238503;6510099;15728404
2022-11-14T09:30:00+02:00;7;Tirol;10398488;4653654;5744834
2022-11-14T09:30:00+02:00;8;Vorarlberg;7255410;1638458;5616952
2022-11-14T09:30:00+02:00;9;Wien;71916297;64255897;7660400
2022-11-14T09:30:00+02:00;10;Österreich;201749564;105779278;95970286
2022-11-15T09:30:00+02:00;1;Burgenland;5780339;2154990;3625349
2022-11-15T09:30:00+02:00;2;Kärnten;6891247;1695774;5195473
2022-11-15T09:30:00+02:00;3;Niederösterreich;40690743;14954778;25735965
2022-11-15T09:30:00+02:00;4;Oberösterreich;25568827;6658574;18910253
2022-11-15T09:30:00+02:00;5;Salzburg;11039867;3269883;7769984
2022-11-15T09:30:00+02:00;6;Steiermark;22243226;6512556;15730670
2022-11-15T09:30:00+02:00;7;Tirol;10402192;4657358;5744834
2022-11-15T09:30:00+02:00;8;Vorarlberg;7256693;1638679;5618014
2022-11-15T09:30:00+02:00;9;Wien;71964537;64303880;7660657
2022-11-15T09:30:00+02:00;10;Österreich;201837671;105846472;95991199
2022-11-16T09:30:00+02:00;1;Burgenland;5785074;2158609;3626465
2022-11-16T09:30:00+02:00;2;Kärnten;6892604;1696903;5195701
2022-11-16T09:30:00+02:00;3;Niederösterreich;40697978;14960202;25737776
2022-11-16T09:30:00+02:00;4;Oberösterreich;25575958;6660384;18915574
2022-11-16T09:30:00+02:00;5;Salzburg;11041376;3271036;7770340
2022-11-16T09:30:00+02:00;6;Steiermark;22260480;6518886;15741594
2022-11-16T09:30:00+02:00;7;Tirol;10404969;4660135;5744834
2022-11-16T09:30:00+02:00;8;Vorarlberg;7257956;1639192;5618764
2022-11-16T09:30:00+02:00;9;Wien;72001978;64341097;7660881
2022-11-16T09:30:00+02:00;10;Österreich;201918373;105906444;96011929
2022-11-17T09:30:00+02:00;1;Burgenland;5787910;2161405;3626505
2022-11-17T09:30:00+02:00;2;Kärnten;6894839;1698237;5196602
2022-11-17T09:30:00+02:00;3;Niederösterreich;40704465;14962734;25741731
2022-11-17T09:30:00+02:00;4;Oberösterreich;25608974;6662174;18946800
2022-11-17T09:30:00+02:00;5;Salzburg;11042910;3272194;7770716
2022-11-17T09:30:00+02:00;6;Steiermark;22266809;6523436;15743373
2022-11-17T09:30:00+02:00;7;Tirol;10407435;4662601;5744834
2022-11-17T09:30:00+02:00;8;Vorarlberg;7259172;1639565;5619607
2022-11-17T09:30:00+02:00;9;Wien;72049965;64388895;7661070
2022-11-17T09:30:00+02:00;10;Österreich;202022479;105971241;96051238
2022-11-18T09:30:00+02:00;1;Burgenland;5790750;2164207;3626543
2022-11-18T09:30:00+02:00;2;Kärnten;6895667;1699065;5196602
2022-11-18T09:30:00+02:00;3;Niederösterreich;40707738;14965004;25742734
2022-11-18T09:30:00+02:00;4;Oberösterreich;25615023;6665042;18949981
2022-11-18T09:30:00+02:00;5;Salzburg;11044142;3273051;7771091
2022-11-18T09:30:00+02:00;6;Steiermark;22272692;6527685;15745007
2022-11-18T09:30:00+02:00;7;Tirol;10409501;4664667;5744834
2022-11-18T09:30:00+02:00;8;Vorarlberg;7260241;1639951;5620290
2022-11-18T09:30:00+02:00;9;Wien;72093046;64431762;7661284
2022-11-18T09:30:00+02:00;10;Österreich;202088800;106030434;96058366
2022-11-19T09:30:00+02:00;1;Burgenland;5790750;2164207;3626543
2022-11-19T09:30:00+02:00;2;Kärnten;6895667;1699065;5196602
2022-11-19T09:30:00+02:00;3;Niederösterreich;40707738;14965004;25742734
2022-11-19T09:30:00+02:00;4;Oberösterreich;25615023;6665042;18949981
2022-11-19T09:30:00+02:00;5;Salzburg;11044142;3273051;7771091
2022-11-19T09:30:00+02:00;6;Steiermark;22272692;6527685;15745007
2022-11-19T09:30:00+02:00;7;Tirol;10409501;4664667;5744834
2022-11-19T09:30:00+02:00;8;Vorarlberg;7260241;1639951;5620290
2022-11-19T09:30:00+02:00;9;Wien;72093046;64431762;7661284
2022-11-19T09:30:00+02:00;10;Österreich;202088800;106030434;96058366
2022-11-20T09:30:00+02:00;1;Burgenland;5790750;2164207;3626543
2022-11-20T09:30:00+02:00;2;Kärnten;6895667;1699065;5196602
2022-11-20T09:30:00+02:00;3;Niederösterreich;40707738;14965004;25742734
2022-11-20T09:30:00+02:00;4;Oberösterreich;25615023;6665042;18949981
2022-11-20T09:30:00+02:00;5;Salzburg;11044142;3273051;7771091
2022-11-20T09:30:00+02:00;6;Steiermark;22272692;6527685;15745007
2022-11-20T09:30:00+02:00;7;Tirol;10409501;4664667;5744834
2022-11-20T09:30:00+02:00;8;Vorarlberg;7260241;1639951;5620290
2022-11-20T09:30:00+02:00;9;Wien;72093046;64431762;7661284
2022-11-20T09:30:00+02:00;10;Österreich;202088800;106030434;96058366
2022-11-21T09:30:00+02:00;1;Burgenland;5797219;2169666;3627553
2022-11-21T09:30:00+02:00;2;Kärnten;6898895;1701268;5197627
2022-11-21T09:30:00+02:00;3;Niederösterreich;40722616;14977828;25744788
2022-11-21T09:30:00+02:00;4;Oberösterreich;25626577;6670055;18956522
2022-11-21T09:30:00+02:00;5;Salzburg;11047262;3275316;7771946
2022-11-21T09:30:00+02:00;6;Steiermark;22285582;6537932;15747650
2022-11-21T09:30:00+02:00;7;Tirol;10414469;4669635;5744834
2022-11-21T09:30:00+02:00;8;Vorarlberg;7262374;1640853;5621521
2022-11-21T09:30:00+02:00;9;Wien;72174563;64512657;7661906
2022-11-21T09:30:00+02:00;10;Österreich;202229557;106155210;96074347
2022-11-22T09:30:00+02:00;1;Burgenland;5799327;2171747;3627580
2022-11-22T09:30:00+02:00;2;Kärnten;6900641;1703014;5197627
2022-11-22T09:30:00+02:00;3;Niederösterreich;40728323;14982033;25746290
2022-11-22T09:30:00+02:00;4;Oberösterreich;25634797;6672136;18962661
2022-11-22T09:30:00+02:00;5;Salzburg;11056463;3276895;7779568
2022-11-22T09:30:00+02:00;6;Steiermark;22290604;6540640;15749964
2022-11-22T09:30:00+02:00;7;Tirol;10418336;4673502;5744834
2022-11-22T09:30:00+02:00;8;Vorarlberg;7263679;1641117;5622562
2022-11-22T09:30:00+02:00;9;Wien;72222191;64560058;7662133
2022-11-22T09:30:00+02:00;10;Österreich;202314361;106221142;96093219
2022-11-23T09:30:00+02:00;1;Burgenland;5804128;2175641;3628487
2022-11-23T09:30:00+02:00;2;Kärnten;6902192;1704565;5197627
2022-11-23T09:30:00+02:00;3;Niederösterreich;40735531;14987235;25748296
2022-11-23T09:30:00+02:00;4;Oberösterreich;25643832;6673755;18970077
2022-11-23T09:30:00+02:00;5;Salzburg;11058044;3278023;7780021
2022-11-23T09:30:00+02:00;6;Steiermark;22307337;6547235;15760102
2022-11-23T09:30:00+02:00;7;Tirol;10421058;4676224;5744834
2022-11-23T09:30:00+02:00;8;Vorarlberg;7265139;1641704;5623435
2022-11-23T09:30:00+02:00;9;Wien;72272733;64610383;7662350
2022-11-23T09:30:00+02:00;10;Österreich;202409994;106294765;96115229
2022-11-24T09:30:00+02:00;1;Burgenland;5807071;2178539;3628532
2022-11-24T09:30:00+02:00;2;Kärnten;6907207;1705575;5201632
2022-11-24T09:30:00+02:00;3;Niederösterreich;40745021;14991525;25753496
2022-11-24T09:30:00+02:00;4;Oberösterreich;25659959;6675769;18984190
2022-11-24T09:30:00+02:00;5;Salzburg;11059592;3279071;7780521
2022-11-24T09:30:00+02:00;6;Steiermark;22321808;6551733;15770075
2022-11-24T09:30:00+02:00;7;Tirol;10423585;4678751;5744834
2022-11-24T09:30:00+02:00;8;Vorarlberg;7266424;1642146;5624278
2022-11-24T09:30:00+02:00;9;Wien;72314414;64651835;7662579
2022-11-24T09:30:00+02:00;10;Österreich;202505081;106354944;96150137
2022-11-25T09:30:00+02:00;1;Burgenland;5813720;2185149;3628571
2022-11-25T09:30:00+02:00;2;Kärnten;6908505;1706873;5201632
2022-11-25T09:30:00+02:00;3;Niederösterreich;40749966;14995244;25754722
2022-11-25T09:30:00+02:00;4;Oberösterreich;25666309;6678672;18987637
2022-11-25T09:30:00+02:00;5;Salzburg;11061026;3280026;7781000
2022-11-25T09:30:00+02:00;6;Steiermark;22327527;6555769;15771758
2022-11-25T09:30:00+02:00;7;Tirol;10425757;4680923;5744834
2022-11-25T09:30:00+02:00;8;Vorarlberg;7267612;1642601;5625011
2022-11-25T09:30:00+02:00;9;Wien;72356144;64693334;7662810
2022-11-25T09:30:00+02:00;10;Österreich;202576566;106418591;96157975
2022-11-26T09:30:00+02:00;1;Burgenland;5813720;2185149;3628571
2022-11-26T09:30:00+02:00;2;Kärnten;6908505;1706873;5201632
2022-11-26T09:30:00+02:00;3;Niederösterreich;40749966;14995244;25754722
2022-11-26T09:30:00+02:00;4;Oberösterreich;25666309;6678672;18987637
2022-11-26T09:30:00+02:00;5;Salzburg;11061026;3280026;7781000
2022-11-26T09:30:00+02:00;6;Steiermark;22327527;6555769;15771758
2022-11-26T09:30:00+02:00;7;Tirol;10425757;4680923;5744834
2022-11-26T09:30:00+02:00;8;Vorarlberg;7267612;1642601;5625011
2022-11-26T09:30:00+02:00;9;Wien;72356144;64693334;7662810
2022-11-26T09:30:00+02:00;10;Österreich;202576566;106418591;96157975
2022-11-27T09:30:00+02:00;1;Burgenland;5813720;2185149;3628571
2022-11-27T09:30:00+02:00;2;Kärnten;6908505;1706873;5201632
2022-11-27T09:30:00+02:00;3;Niederösterreich;40749966;14995244;25754722
2022-11-27T09:30:00+02:00;4;Oberösterreich;25666309;6678672;18987637
2022-11-27T09:30:00+02:00;5;Salzburg;11061026;3280026;7781000
2022-11-27T09:30:00+02:00;6;Steiermark;22327527;6555769;15771758
2022-11-27T09:30:00+02:00;7;Tirol;10425757;4680923;5744834
2022-11-27T09:30:00+02:00;8;Vorarlberg;7267612;1642601;5625011
2022-11-27T09:30:00+02:00;9;Wien;72356144;64693334;7662810
2022-11-27T09:30:00+02:00;10;Österreich;202576566;106418591;96157975
2022-11-28T09:30:00+02:00;1;Burgenland;5820996;2191964;3629032
2022-11-28T09:30:00+02:00;2;Kärnten;6911502;1708956;5202546
2022-11-28T09:30:00+02:00;3;Niederösterreich;40763888;15007363;25756525
2022-11-28T09:30:00+02:00;4;Oberösterreich;25678005;6683625;18994380
2022-11-28T09:30:00+02:00;5;Salzburg;11064438;3282329;7782109
2022-11-28T09:30:00+02:00;6;Steiermark;22341103;6566501;15774602
2022-11-28T09:30:00+02:00;7;Tirol;10430893;4686059;5744834
2022-11-28T09:30:00+02:00;8;Vorarlberg;7269939;1643739;5626200
2022-11-28T09:30:00+02:00;9;Wien;72442793;64779283;7663510
2022-11-28T09:30:00+02:00;10;Österreich;202723557;106549819;96173738
2022-11-29T09:30:00+02:00;1;Burgenland;5825354;2195221;3630133
2022-11-29T09:30:00+02:00;2;Kärnten;6913391;1710845;5202546
2022-11-29T09:30:00+02:00;3;Niederösterreich;40768614;15010917;25757697
2022-11-29T09:30:00+02:00;4;Oberösterreich;25688437;6685738;19002699
2022-11-29T09:30:00+02:00;5;Salzburg;11074175;3283889;7790286
2022-11-29T09:30:00+02:00;6;Steiermark;22346337;6569174;15777163
2022-11-29T09:30:00+02:00;7;Tirol;10152808;4407974;5744834
2022-11-29T09:30:00+02:00;8;Vorarlberg;7271395;1643995;5627400
2022-11-29T09:30:00+02:00;9;Wien;72494891;64831068;7663823
2022-11-29T09:30:00+02:00;10;Österreich;202535402;106338821;96196581
2022-11-30T09:30:00+02:00;1;Burgenland;5829910;2198753;3631157
2022-11-30T09:30:00+02:00;2;Kärnten;6914843;1711878;5202965
2022-11-30T09:30:00+02:00;3;Niederösterreich;40777670;15015865;25761805
2022-11-30T09:30:00+02:00;4;Oberösterreich;25707455;6687683;19019772
2022-11-30T09:30:00+02:00;5;Salzburg;11075859;3285011;7790848
2022-11-30T09:30:00+02:00;6;Steiermark;22370292;6576211;15794081
2022-11-30T09:30:00+02:00;7;Tirol;10155870;4411036;5744834
2022-11-30T09:30:00+02:00;8;Vorarlberg;7273198;1644682;5628516
2022-11-30T09:30:00+02:00;9;Wien;72541478;64877430;7664048
2022-11-30T09:30:00+02:00;10;Österreich;202646575;106408549;96238026
2022-12-01T09:30:00+02:00;1;Burgenland;5832896;2201702;3631194
2022-12-01T09:30:00+02:00;2;Kärnten;6917567;1713205;5204362
2022-12-01T09:30:00+02:00;3;Niederösterreich;40783826;15020336;25763490
2022-12-01T09:30:00+02:00;4;Oberösterreich;25713160;6689768;19023392
2022-12-01T09:30:00+02:00;5;Salzburg;11077684;3286275;7791409
2022-12-01T09:30:00+02:00;6;Steiermark;22377469;6580948;15796521
2022-12-01T09:30:00+02:00;7;Tirol;10158866;4414032;5744834
2022-12-01T09:30:00+02:00;8;Vorarlberg;7274684;1645220;5629464
2022-12-01T09:30:00+02:00;9;Wien;72585231;64920963;7664268
2022-12-01T09:30:00+02:00;10;Österreich;202721383;106472449;96248934
2022-12-02T09:30:00+02:00;1;Burgenland;5835795;2204559;3631236
2022-12-02T09:30:00+02:00;2;Kärnten;6918575;1714213;5204362
2022-12-02T09:30:00+02:00;3;Niederösterreich;40788413;15024127;25764286
2022-12-02T09:30:00+02:00;4;Oberösterreich;25719302;6692369;19026933
2022-12-02T09:30:00+02:00;5;Salzburg;11079239;3287280;7791959
2022-12-02T09:30:00+02:00;6;Steiermark;22384148;6585792;15798356
2022-12-02T09:30:00+02:00;7;Tirol;10161276;4416442;5744834
2022-12-02T09:30:00+02:00;8;Vorarlberg;7276074;1645678;5630396
2022-12-02T09:30:00+02:00;9;Wien;72628682;64964099;7664583
2022-12-02T09:30:00+02:00;10;Österreich;202791504;106534559;96256945
2022-12-03T09:30:00+02:00;1;Burgenland;5835795;2204559;3631236
2022-12-03T09:30:00+02:00;2;Kärnten;6918575;1714213;5204362
2022-12-03T09:30:00+02:00;3;Niederösterreich;40788413;15024127;25764286
2022-12-03T09:30:00+02:00;4;Oberösterreich;25719302;6692369;19026933
2022-12-03T09:30:00+02:00;5;Salzburg;11079239;3287280;7791959
2022-12-03T09:30:00+02:00;6;Steiermark;22384148;6585792;15798356
2022-12-03T09:30:00+02:00;7;Tirol;10161276;4416442;5744834
2022-12-03T09:30:00+02:00;8;Vorarlberg;7276074;1645678;5630396
2022-12-03T09:30:00+02:00;9;Wien;72628682;64964099;7664583
2022-12-03T09:30:00+02:00;10;Österreich;202791504;106534559;96256945
2022-12-04T09:30:00+02:00;1;Burgenland;5835795;2204559;3631236
2022-12-04T09:30:00+02:00;2;Kärnten;6918575;1714213;5204362
2022-12-04T09:30:00+02:00;3;Niederösterreich;40788413;15024127;25764286
2022-12-04T09:30:00+02:00;4;Oberösterreich;25719302;6692369;19026933
2022-12-04T09:30:00+02:00;5;Salzburg;11079239;3287280;7791959
2022-12-04T09:30:00+02:00;6;Steiermark;22384148;6585792;15798356
2022-12-04T09:30:00+02:00;7;Tirol;10161276;4416442;5744834
2022-12-04T09:30:00+02:00;8;Vorarlberg;7276074;1645678;5630396
2022-12-04T09:30:00+02:00;9;Wien;72628682;64964099;7664583
2022-12-04T09:30:00+02:00;10;Österreich;202791504;106534559;96256945
2022-12-05T09:30:00+02:00;1;Burgenland;5844312;2211463;3632849
2022-12-05T09:30:00+02:00;2;Kärnten;6921407;1716086;5205321
2022-12-05T09:30:00+02:00;3;Niederösterreich;40802425;15036659;25765766
2022-12-05T09:30:00+02:00;4;Oberösterreich;25729825;6697859;19031966
2022-12-05T09:30:00+02:00;5;Salzburg;11082991;3289823;7793168
2022-12-05T09:30:00+02:00;6;Steiermark;22397674;6596131;15801543
2022-12-05T09:30:00+02:00;7;Tirol;10148505;4403671;5744834
2022-12-05T09:30:00+02:00;8;Vorarlberg;7278589;1646655;5631934
2022-12-05T09:30:00+02:00;9;Wien;72722756;65057477;7665279
2022-12-05T09:30:00+02:00;10;Österreich;202928484;106655824;96272660
2022-12-06T09:30:00+02:00;1;Burgenland;5846451;2213567;3632884
2022-12-06T09:30:00+02:00;2;Kärnten;6924009;1718473;5205536
2022-12-06T09:30:00+02:00;3;Niederösterreich;40808498;15040828;25767670
2022-12-06T09:30:00+02:00;4;Oberösterreich;25761207;6699892;19061315
2022-12-06T09:30:00+02:00;5;Salzburg;11092899;3291423;7801476
2022-12-06T09:30:00+02:00;6;Steiermark;22403069;6598834;15804235
2022-12-06T09:30:00+02:00;7;Tirol;10170907;4426073;5744834
2022-12-06T09:30:00+02:00;8;Vorarlberg;7279978;1646925;5633053
2022-12-06T09:30:00+02:00;9;Wien;72773117;65107495;7665622
2022-12-06T09:30:00+02:00;10;Österreich;203060135;106743510;96316625
2022-12-07T09:30:00+02:00;1;Burgenland;5851989;2218185;3633804
2022-12-07T09:30:00+02:00;2;Kärnten;6925483;1719493;5205990
2022-12-07T09:30:00+02:00;3;Niederösterreich;40818854;15045754;25773100
2022-12-07T09:30:00+02:00;4;Oberösterreich;25768850;6701886;19066964
2022-12-07T09:30:00+02:00;5;Salzburg;11094677;3292588;7802089
2022-12-07T09:30:00+02:00;6;Steiermark;22426927;6605691;15821236
2022-12-07T09:30:00+02:00;7;Tirol;10173574;4428740;5744834
2022-12-07T09:30:00+02:00;8;Vorarlberg;7281425;1647553;5633872
2022-12-07T09:30:00+02:00;9;Wien;72814657;65148727;7665930
2022-12-07T09:30:00+02:00;10;Österreich;203156436;106808617;96347819
2022-12-08T09:30:00+02:00;1;Burgenland;5851989;2218185;3633804
2022-12-08T09:30:00+02:00;2;Kärnten;6925483;1719493;5205990
2022-12-08T09:30:00+02:00;3;Niederösterreich;40818854;15045754;25773100
2022-12-08T09:30:00+02:00;4;Oberösterreich;25768850;6701886;19066964
2022-12-08T09:30:00+02:00;5;Salzburg;11094677;3292588;7802089
2022-12-08T09:30:00+02:00;6;Steiermark;22426927;6605691;15821236
2022-12-08T09:30:00+02:00;7;Tirol;10173574;4428740;5744834
2022-12-08T09:30:00+02:00;8;Vorarlberg;7281425;1647553;5633872
2022-12-08T09:30:00+02:00;9;Wien;72814657;65148727;7665930
2022-12-08T09:30:00+02:00;10;Österreich;203156436;106808617;96347819
2022-12-09T09:30:00+02:00;1;Burgenland;5857787;2223917;3633870
2022-12-09T09:30:00+02:00;2;Kärnten;6927232;1721139;5206093
2022-12-09T09:30:00+02:00;3;Niederösterreich;40831297;15053883;25777414
2022-12-09T09:30:00+02:00;4;Oberösterreich;25790281;6706198;19084083
2022-12-09T09:30:00+02:00;5;Salzburg;11097372;3294302;7803070
2022-12-09T09:30:00+02:00;6;Steiermark;22437302;6613632;15823670
2022-12-09T09:30:00+02:00;7;Tirol;10177004;4432170;5744834
2022-12-09T09:30:00+02:00;8;Vorarlberg;7283450;1648412;5635038
2022-12-09T09:30:00+02:00;9;Wien;72888365;65221969;7666396
2022-12-09T09:30:00+02:00;10;Österreich;203290090;106915622;96374468
2022-12-10T09:30:00+02:00;1;Burgenland;5857787;2223917;3633870
2022-12-10T09:30:00+02:00;2;Kärnten;6927232;1721139;5206093
2022-12-10T09:30:00+02:00;3;Niederösterreich;40831297;15053883;25777414
2022-12-10T09:30:00+02:00;4;Oberösterreich;25790281;6706198;19084083
2022-12-10T09:30:00+02:00;5;Salzburg;11097372;3294302;7803070
2022-12-10T09:30:00+02:00;6;Steiermark;22437302;6613632;15823670
2022-12-10T09:30:00+02:00;7;Tirol;10177004;4432170;5744834
2022-12-10T09:30:00+02:00;8;Vorarlberg;7283450;1648412;5635038
2022-12-10T09:30:00+02:00;9;Wien;72888365;65221969;7666396
2022-12-10T09:30:00+02:00;10;Österreich;203290090;106915622;96374468
2022-12-11T09:30:00+02:00;1;Burgenland;5857787;2223917;3633870
2022-12-11T09:30:00+02:00;2;Kärnten;6927232;1721139;5206093
2022-12-11T09:30:00+02:00;3;Niederösterreich;40831297;15053883;25777414
2022-12-11T09:30:00+02:00;4;Oberösterreich;25790281;6706198;19084083
2022-12-11T09:30:00+02:00;5;Salzburg;11097372;3294302;7803070
2022-12-11T09:30:00+02:00;6;Steiermark;22437302;6613632;15823670
2022-12-11T09:30:00+02:00;7;Tirol;10177004;4432170;5744834
2022-12-11T09:30:00+02:00;8;Vorarlberg;7283450;1648412;5635038
2022-12-11T09:30:00+02:00;9;Wien;72888365;65221969;7666396
2022-12-11T09:30:00+02:00;10;Österreich;203290090;106915622;96374468
2022-12-12T09:30:00+02:00;1;Burgenland;5865106;2229860;3635246
2022-12-12T09:30:00+02:00;2;Kärnten;6931196;1723523;5207673
2022-12-12T09:30:00+02:00;3;Niederösterreich;40845585;15064905;25780680
2022-12-12T09:30:00+02:00;4;Oberösterreich;25802056;6710547;19091509
2022-12-12T09:30:00+02:00;5;Salzburg;11101296;3296880;7804416
2022-12-12T09:30:00+02:00;6;Steiermark;22449397;6622503;15826894
2022-12-12T09:30:00+02:00;7;Tirol;10182585;4437751;5744834
2022-12-12T09:30:00+02:00;8;Vorarlberg;7285941;1649400;5636541
2022-12-12T09:30:00+02:00;9;Wien;72977513;65310374;7667139
2022-12-12T09:30:00+02:00;10;Österreich;203440675;107045743;96394932
2022-12-13T09:30:00+02:00;1;Burgenland;5868085;2232813;3635272
2022-12-13T09:30:00+02:00;2;Kärnten;6934218;1725273;5208945
2022-12-13T09:30:00+02:00;3;Niederösterreich;40850079;15067928;25782151
2022-12-13T09:30:00+02:00;4;Oberösterreich;25810923;6713232;19097691
2022-12-13T09:30:00+02:00;5;Salzburg;11111088;3298299;7812789
2022-12-13T09:30:00+02:00;6;Steiermark;22465890;6625771;15840119
2022-12-13T09:30:00+02:00;7;Tirol;10186648;4441814;5744834
2022-12-13T09:30:00+02:00;8;Vorarlberg;7287498;1649712;5637786
2022-12-13T09:30:00+02:00;9;Wien;73025608;65358153;7667455
2022-12-13T09:30:00+02:00;10;Österreich;203540037;107112995;96427042
2022-12-14T09:30:00+02:00;1;Burgenland;5873768;2237477;3636291
2022-12-14T09:30:00+02:00;2;Kärnten;6935641;1726181;5209460
2022-12-14T09:30:00+02:00;3;Niederösterreich;40860619;15074020;25786599
2022-12-14T09:30:00+02:00;4;Oberösterreich;25825562;6715197;19110365
2022-12-14T09:30:00+02:00;5;Salzburg;11113083;3299623;7813460
2022-12-14T09:30:00+02:00;6;Steiermark;22487336;6632705;15854631
2022-12-14T09:30:00+02:00;7;Tirol;10189591;4444757;5744834
2022-12-14T09:30:00+02:00;8;Vorarlberg;7289131;1650465;5638666
2022-12-14T09:30:00+02:00;9;Wien;73075627;65407900;7667727
2022-12-14T09:30:00+02:00;10;Österreich;203650358;107188325;96462033
2022-12-15T09:30:00+02:00;1;Burgenland;5877226;2240892;3636334
2022-12-15T09:30:00+02:00;2;Kärnten;6940494;1728219;5212275
2022-12-15T09:30:00+02:00;3;Niederösterreich;40867069;15077986;25789083
2022-12-15T09:30:00+02:00;4;Oberösterreich;25831615;6716914;19114701
2022-12-15T09:30:00+02:00;5;Salzburg;11115059;3300946;7814113
2022-12-15T09:30:00+02:00;6;Steiermark;22494557;6637780;15856777
2022-12-15T09:30:00+02:00;7;Tirol;10192503;4447669;5744834
2022-12-15T09:30:00+02:00;8;Vorarlberg;7290884;1651040;5639844
2022-12-15T09:30:00+02:00;9;Wien;73117964;65449975;7667989
2022-12-15T09:30:00+02:00;10;Österreich;203727371;107251421;96475950
2022-12-16T09:30:00+02:00;1;Burgenland;5880131;2243758;3636373
2022-12-16T09:30:00+02:00;2;Kärnten;6941369;1729094;5212275
2022-12-16T09:30:00+02:00;3;Niederösterreich;40873188;15081431;25791757
2022-12-16T09:30:00+02:00;4;Oberösterreich;25842765;6720009;19122756
2022-12-16T09:30:00+02:00;5;Salzburg;11116638;3301868;7814770
2022-12-16T09:30:00+02:00;6;Steiermark;22501452;6642700;15858752
2022-12-16T09:30:00+02:00;7;Tirol;10194685;4449851;5744834
2022-12-16T09:30:00+02:00;8;Vorarlberg;7292170;1651493;5640677
2022-12-16T09:30:00+02:00;9;Wien;73164800;65496693;7668107
2022-12-16T09:30:00+02:00;10;Österreich;203807198;107316897;96490301
2022-12-17T09:30:00+02:00;1;Burgenland;5880131;2243758;3636373
2022-12-17T09:30:00+02:00;2;Kärnten;6941369;1729094;5212275
2022-12-17T09:30:00+02:00;3;Niederösterreich;40873188;15081431;25791757
2022-12-17T09:30:00+02:00;4;Oberösterreich;25842765;6720009;19122756
2022-12-17T09:30:00+02:00;5;Salzburg;11116638;3301868;7814770
2022-12-17T09:30:00+02:00;6;Steiermark;22501452;6642700;15858752
2022-12-17T09:30:00+02:00;7;Tirol;10194685;4449851;5744834
2022-12-17T09:30:00+02:00;8;Vorarlberg;7292170;1651493;5640677
2022-12-17T09:30:00+02:00;9;Wien;73164800;65496693;7668107
2022-12-17T09:30:00+02:00;10;Österreich;203807198;107316897;96490301
2022-12-18T09:30:00+02:00;1;Burgenland;5880131;2243758;3636373
2022-12-18T09:30:00+02:00;2;Kärnten;6941369;1729094;5212275
2022-12-18T09:30:00+02:00;3;Niederösterreich;40873188;15081431;25791757
2022-12-18T09:30:00+02:00;4;Oberösterreich;25842765;6720009;19122756
2022-12-18T09:30:00+02:00;5;Salzburg;11116638;3301868;7814770
2022-12-18T09:30:00+02:00;6;Steiermark;22501452;6642700;15858752
2022-12-18T09:30:00+02:00;7;Tirol;10194685;4449851;5744834
2022-12-18T09:30:00+02:00;8;Vorarlberg;7292170;1651493;5640677
2022-12-18T09:30:00+02:00;9;Wien;73164800;65496693;7668107
2022-12-18T09:30:00+02:00;10;Österreich;203807198;107316897;96490301
2022-12-19T09:30:00+02:00;1;Burgenland;5887443;2250229;3637214
2022-12-19T09:30:00+02:00;2;Kärnten;6942778;1730252;5212526
2022-12-19T09:30:00+02:00;3;Niederösterreich;40888560;15094085;25794475
2022-12-19T09:30:00+02:00;4;Oberösterreich;25852967;6725179;19127788
2022-12-19T09:30:00+02:00;5;Salzburg;11119266;3303866;7815400
2022-12-19T09:30:00+02:00;6;Steiermark;22511796;6651270;15860526
2022-12-19T09:30:00+02:00;7;Tirol;10198592;4453758;5744834
2022-12-19T09:30:00+02:00;8;Vorarlberg;7294121;1652546;5641575
2022-12-19T09:30:00+02:00;9;Wien;73257152;65588256;7668896
2022-12-19T09:30:00+02:00;10;Österreich;203952675;107449441;96503234
2022-12-20T09:30:00+02:00;1;Burgenland;5890077;2252021;3638056
2022-12-20T09:30:00+02:00;2;Kärnten;6947449;1731780;5215669
2022-12-20T09:30:00+02:00;3;Niederösterreich;40895174;15098961;25796213
2022-12-20T09:30:00+02:00;4;Oberösterreich;25859786;6727126;19132660
2022-12-20T09:30:00+02:00;5;Salzburg;11127856;3304890;7822966
2022-12-20T09:30:00+02:00;6;Steiermark;22515339;6653515;15861824
2022-12-20T09:30:00+02:00;7;Tirol;10201158;4456324;5744834
2022-12-20T09:30:00+02:00;8;Vorarlberg;7295131;1652804;5642327
2022-12-20T09:30:00+02:00;9;Wien;73308019;65638829;7669190
2022-12-20T09:30:00+02:00;10;Österreich;204039989;107516250;96523739